,origem,destino,distance,STEPS_Status.FULL_JUMP,STEPS_Status.SINGLE_JUMP,STEPS_Status.SEQUENTIAL
0,798,781,-17,65,969,984
1,535,46,-489,36,497,512
2,188,200,12,3,6,13
3,118,408,290,20,276,291
4,677,343,-334,44,652,667
5,662,925,263,20,249,264
6,225,440,215,17,201,216
7,119,456,337,23,323,338
8,943,229,-714,21,272,287
9,68,7,-61,62,925,940
10,762,234,-528,31,458,473
11,415,463,48,4,34,49
12,157,147,-10,65,976,991
13,815,690,-125,58,861,876
14,401,995,594,39,580,595
15,317,43,-274,48,712,727
16,950,657,-293,47,693,708
17,514,187,-327,44,659,674
18,469,137,-332,44,654,669
19,157,318,161,12,147,162
20,687,941,254,19,240,255
21,639,417,-222,51,764,779
22,742,635,-107,59,879,894
23,897,903,6,3,4,7
24,134,48,-86,59,900,915
25,539,375,-164,54,822,837
26,932,619,-313,47,673,688
27,225,181,-44,62,942,957
28,57,884,827,55,813,828
29,836,225,-611,27,375,390
30,911,524,-387,41,599,614
31,178,980,802,52,788,803
32,144,549,405,28,391,406
33,278,503,225,16,211,226
34,606,411,-195,53,791,806
35,731,826,95,10,81,96
36,900,537,-363,43,623,638
37,808,125,-683,23,303,318
38,118,90,-28,63,958,973
39,950,256,-694,21,292,307
40,915,919,4,2,2,5
41,389,368,-21,64,965,980
42,668,487,-181,54,805,820
43,830,354,-476,35,510,525
44,242,127,-115,58,871,886
45,997,302,-695,21,291,306
46,484,144,-340,43,646,661
47,150,924,774,51,760,775
48,871,550,-321,46,665,680
49,965,410,-555,31,431,446
50,709,955,246,18,232,247
51,186,174,-12,64,974,989
52,0,268,268,19,254,269
53,296,912,616,40,602,617
54,639,485,-154,56,832,847
55,665,295,-370,42,616,631
56,560,565,5,3,3,6
57,555,298,-257,50,729,744
58,831,408,-423,38,563,578
59,634,406,-228,50,758,773
60,899,229,-670,23,316,331
61,129,334,205,16,191,206
62,190,585,395,28,381,396
63,16,747,731,49,717,732
64,11,847,836,54,822,837
65,426,924,498,33,484,499
66,508,4,-504,32,482,497
67,194,270,76,7,62,77
68,181,71,-110,58,876,891
69,480,487,7,4,5,8
70,868,360,-508,33,478,493
71,517,424,-93,60,893,908
72,118,960,842,55,828,843
73,99,529,430,30,416,431
74,845,759,-86,59,900,915
75,963,146,-817,15,169,184
76,830,177,-653,25,333,348
77,136,412,276,19,262,277
78,287,984,697,46,683,698
79,545,221,-324,44,662,677
80,561,559,-2,65,984,999
81,991,152,-839,12,147,162
82,848,367,-481,36,505,520
83,565,148,-417,40,569,584
84,57,599,542,37,528,543
85,843,868,25,4,11,26
86,917,271,-646,24,340,355
87,851,224,-627,26,359,374
88,531,416,-115,58,871,886
89,168,87,-81,61,905,920
90,683,210,-473,37,513,528
91,802,94,-708,20,278,293
92,60,882,822,54,808,823
93,861,250,-611,27,375,390
94,97,337,240,16,226,241
95,599,461,-138,57,848,863
96,680,941,261,19,247,262
97,517,130,-387,41,599,614
98,164,234,70,7,56,71
99,809,797,-12,64,974,989
100,874,482,-392,39,594,609
101,712,676,-36,62,950,965
102,894,837,-57,63,929,944
103,241,906,665,44,651,666
104,276,938,662,44,648,663
105,999,583,-416,38,570,585
106,385,593,208,14,194,209
107,533,543,10,3,4,11
108,56,426,370,25,356,371
109,708,641,-67,61,919,934
110,358,453,95,10,81,96
111,834,104,-730,20,256,271
112,266,15,-251,50,735,750
113,207,302,95,10,81,96
114,0,875,875,58,861,876
115,382,325,-57,63,929,944
116,136,580,444,30,430,445
117,443,771,328,22,314,329
118,56,281,225,16,211,226
119,676,79,-597,28,389,404
120,363,898,535,37,521,536
121,83,549,466,31,452,467
122,959,734,-225,52,761,776
123,279,41,-238,50,748,763
124,743,862,119,11,105,120
125,390,679,289,20,275,290
126,444,26,-418,39,568,583
127,685,664,-21,64,965,980
128,399,571,172,13,158,173
129,155,24,-131,57,855,870
130,184,177,-7,64,979,994
131,998,465,-533,32,453,468
132,177,494,317,23,303,318
133,378,121,-257,50,729,744
134,21,671,650,43,636,651
135,397,733,336,22,322,337
136,569,212,-357,43,629,644
137,851,320,-531,32,455,470
138,240,147,-93,60,893,908
139,92,938,846,56,832,847
140,157,527,370,25,356,371
141,584,862,278,20,264,279
142,874,665,-209,53,777,792
143,575,832,257,18,243,258
144,811,281,-530,32,456,471
145,358,973,615,42,601,616
146,652,726,74,7,60,75
147,459,124,-335,44,651,666
148,831,127,-704,20,282,297
149,241,698,457,31,443,458
150,633,772,139,12,125,140
151,952,381,-571,30,415,430
152,178,892,714,47,700,715
153,19,407,388,26,374,389
154,304,521,217,16,203,218
155,214,356,142,12,128,143
156,64,993,929,60,915,930
157,995,882,-113,59,873,888
158,223,479,256,17,242,257
159,587,848,261,19,247,262
160,739,933,194,14,180,195
161,36,425,389,27,375,390
162,746,698,-48,61,938,953
163,74,474,400,26,386,401
164,894,497,-397,41,589,604
165,619,631,12,3,6,13
166,866,124,-742,18,244,259
167,776,716,-60,61,926,941
168,638,293,-345,45,641,656
169,347,657,310,22,296,311
170,361,420,59,7,45,60
171,862,544,-318,45,668,683
172,604,729,125,11,111,126
173,310,857,547,37,533,548
174,535,842,307,22,293,308
175,821,842,21,4,7,22
176,712,524,-188,53,798,813
177,917,670,-247,49,739,754
178,410,132,-278,47,708,723
179,355,956,601,40,587,602
180,902,705,-197,53,789,804
181,891,337,-554,31,432,447
182,470,215,-255,49,731,746
183,150,106,-44,62,942,957
184,239,249,10,3,4,11
185,953,928,-25,65,961,976
186,59,44,-15,64,971,986
187,878,461,-417,40,569,584
188,487,360,-127,57,859,874
189,493,695,202,15,188,203
190,956,116,-840,11,146,161
191,71,116,45,6,31,46
192,782,777,-5,65,981,996
193,459,480,21,4,7,22
194,204,472,268,19,254,269
195,589,839,250,18,236,251
196,64,106,42,5,28,43
197,489,984,495,35,481,496
198,143,56,-87,59,899,914
199,121,794,673,44,659,674
200,169,681,512,33,498,513
201,538,785,247,19,233,248
202,169,168,-1,66,985,1000
203,755,997,242,17,228,243
204,58,966,908,59,894,909
205,861,62,-799,15,187,202
206,738,204,-534,31,452,467
207,286,723,437,30,423,438
208,268,167,-101,59,885,900
209,591,784,193,14,179,194
210,381,887,506,34,492,507
211,548,733,185,14,171,186
212,741,374,-367,42,619,634
213,617,453,-164,54,822,837
214,50,496,446,31,432,447
215,375,803,428,29,414,429
216,998,799,-199,52,787,802
217,908,245,-663,23,323,338
218,815,812,-3,65,983,998
219,648,58,-590,28,396,411
220,443,953,510,35,496,511
221,285,756,471,33,457,472
222,664,680,16,2,2,17
223,45,907,862,57,848,863
224,551,390,-161,56,825,840
225,386,360,-26,64,960,975
226,624,194,-430,38,556,571
227,274,696,422,29,408,423
228,973,693,-280,46,706,721
229,182,303,121,10,107,122
230,453,713,260,18,246,261
231,772,611,-161,56,825,840
232,991,730,-261,49,725,740
233,296,875,579,39,565,580
234,824,231,-593,29,393,408
235,454,291,-163,55,823,838
236,342,166,-176,53,810,825
237,790,649,-141,57,845,860
238,137,659,522,35,508,523
239,735,794,59,7,45,60
240,139,581,442,30,428,443
241,116,853,737,48,723,738
242,71,981,910,60,896,911
243,288,642,354,24,340,355
244,721,61,-660,23,326,341
245,552,408,-144,55,842,857
246,492,170,-322,45,664,679
247,430,952,522,35,508,523
248,901,555,-346,44,640,655
249,418,177,-241,51,745,760
250,909,584,-325,45,661,676
251,741,458,-283,48,703,718
252,946,470,-476,35,510,525
253,861,160,-701,22,285,300
254,836,274,-562,30,424,439
255,810,623,-187,54,799,814
256,245,812,567,39,553,568
257,373,193,-180,53,806,821
258,754,882,128,9,114,129
259,474,460,-14,64,972,987
260,619,100,-519,32,467,482
261,512,960,448,29,434,449
262,151,363,212,15,198,213
263,428,882,454,31,440,455
264,1,48,47,7,33,48
265,337,144,-193,54,793,808
266,175,321,146,11,132,147
267,784,914,130,10,116,131
268,30,29,-1,66,985,1000
269,921,118,-803,15,183,198
270,339,973,634,42,620,635
271,617,88,-529,33,457,472
272,856,307,-549,31,437,452
273,773,351,-422,38,564,579
274,136,610,474,32,460,475
275,715,275,-440,36,546,561
276,389,903,514,34,500,515
277,570,422,-148,55,838,853
278,337,291,-46,62,940,955
279,472,714,242,17,228,243
280,865,110,-755,18,231,246
281,756,762,6,3,4,7
282,244,482,238,18,224,239
283,458,767,309,22,295,310
284,647,123,-524,32,462,477
285,318,619,301,22,287,302
286,516,684,168,12,154,169
287,963,289,-674,23,312,327
288,506,877,371,26,357,372
289,677,951,274,19,260,275
290,972,312,-660,23,326,341
291,860,413,-447,37,539,554
292,665,345,-320,44,666,681
293,422,339,-83,60,903,918
294,260,748,488,32,474,489
295,596,555,-41,64,945,960
296,37,356,319,24,305,320
297,888,278,-610,27,376,391
298,560,797,237,18,223,238
299,732,835,103,10,89,104
300,109,312,203,16,189,204
301,471,25,-446,37,540,555
302,70,163,93,9,79,94
303,426,13,-413,40,573,588
304,374,473,99,9,85,100
305,724,310,-414,39,572,587
306,863,895,32,3,18,33
307,327,536,209,15,195,210
308,206,406,200,14,186,201
309,157,931,774,51,760,775
310,2,690,688,44,674,689
311,911,646,-265,50,721,736
312,583,124,-459,37,527,542
313,933,108,-825,15,161,176
314,912,794,-118,57,868,883
315,379,370,-9,66,977,992
316,970,113,-857,13,129,144
317,117,212,95,10,81,96
318,609,627,18,3,4,19
319,169,265,96,7,82,97
320,707,319,-388,40,598,613
321,560,366,-194,53,792,807
322,765,452,-313,47,673,688
323,875,72,-803,15,183,198
324,419,199,-220,51,766,781
325,820,26,-794,16,192,207
326,72,253,181,14,167,182
327,469,604,135,12,121,136
328,216,130,-86,59,900,915
329,542,574,32,3,18,33
330,236,359,123,11,109,124
331,430,643,213,16,199,214
332,685,30,-655,24,331,346
333,540,61,-479,35,507,522
334,492,160,-332,44,654,669
335,714,238,-476,35,510,525
336,224,30,-194,53,792,807
337,751,858,107,10,93,108
338,665,164,-501,34,485,500
339,691,380,-311,45,675,690
340,589,240,-349,44,637,652
341,216,777,561,37,547,562
342,772,932,160,11,146,161
343,372,884,512,33,498,513
344,192,979,787,52,773,788
345,777,413,-364,42,622,637
346,819,991,172,13,158,173
347,391,490,99,9,85,100
348,376,57,-319,45,667,682
349,33,143,110,10,96,111
350,17,604,587,40,573,588
351,579,208,-371,42,615,630
352,130,328,198,15,184,199
353,891,962,71,8,57,72
354,743,801,58,6,44,59
355,554,432,-122,58,864,879
356,741,425,-316,45,670,685
357,301,753,452,30,438,453
358,22,554,532,35,518,533
359,199,321,122,10,108,123
360,701,487,-214,51,772,787
361,480,833,353,24,339,354
362,958,109,-849,13,137,152
363,542,32,-510,33,476,491
364,921,598,-323,45,663,678
365,161,507,346,24,332,347
366,720,498,-222,51,764,779
367,698,336,-362,43,624,639
368,5,749,744,48,730,745
369,725,504,-221,52,765,780
370,393,283,-110,58,876,891
371,119,233,114,9,100,115
372,207,95,-112,57,874,889
373,30,451,421,29,407,422
374,975,553,-422,38,564,579
375,479,799,320,21,306,321
376,849,258,-591,28,395,410
377,202,478,276,19,262,277
378,179,43,-136,55,850,865
379,343,266,-77,61,909,924
380,92,449,357,25,343,358
381,141,171,30,5,16,31
382,823,563,-260,48,726,741
383,189,137,-52,61,934,949
384,817,125,-692,21,294,309
385,861,688,-173,55,813,828
386,293,618,325,23,311,326
387,550,647,97,8,83,98
388,491,221,-270,48,716,731
389,285,213,-72,59,914,929
390,770,484,-286,47,700,715
391,803,830,27,5,13,28
392,571,727,156,12,142,157
393,491,430,-61,62,925,940
394,314,142,-172,54,814,829
395,46,449,403,28,389,404
396,389,348,-41,64,945,960
397,583,881,298,21,284,299
398,68,665,597,40,583,598
399,639,534,-105,60,881,896
400,320,467,147,12,133,148
401,828,603,-225,52,761,776
402,979,417,-562,30,424,439
403,502,371,-131,57,855,870
404,169,4,-165,55,821,836
405,179,863,684,45,670,685
406,854,923,69,7,55,70
407,486,4,-482,35,504,519
408,80,416,336,22,322,337
409,981,929,-52,61,934,949
410,688,547,-141,57,845,860
411,904,335,-569,31,417,432
412,143,171,28,4,14,29
413,42,283,241,17,227,242
414,706,668,-38,62,948,963
415,282,577,295,22,281,296
416,153,751,598,40,584,599
417,269,996,727,49,713,728
418,265,727,462,32,448,463
419,987,124,-863,11,123,138
420,694,372,-322,45,664,679
421,787,652,-135,56,851,866
422,176,271,95,10,81,96
423,895,646,-249,51,737,752
424,234,118,-116,57,870,885
425,443,578,135,12,121,136
426,461,336,-125,58,861,876
427,846,20,-826,14,160,175
428,692,339,-353,44,633,648
429,957,827,-130,57,856,871
430,51,672,621,42,607,622
431,353,861,508,34,494,509
432,475,853,378,26,364,379
433,981,669,-312,44,674,689
434,8,680,672,43,658,673
435,296,396,100,8,86,101
436,515,208,-307,46,679,694
437,400,931,531,36,517,532
438,238,228,-10,65,976,991
439,826,4,-822,13,164,179
440,491,906,415,30,401,416
441,227,149,-78,60,908,923
442,169,39,-130,57,856,871
443,284,288,4,2,2,5
444,892,327,-565,30,421,436
445,789,294,-495,34,491,506
446,334,345,11,4,5,12
447,35,901,866,56,852,867
448,347,669,322,22,308,323
449,822,888,66,6,52,67
450,780,956,176,12,162,177
451,477,726,249,18,235,250
452,444,829,385,26,371,386
453,146,834,688,44,674,689
454,435,212,-223,51,763,778
455,368,220,-148,55,838,853
456,481,325,-156,55,830,845
457,292,775,483,33,469,484
458,692,164,-528,31,458,473
459,730,87,-643,25,343,358
460,461,54,-407,39,579,594
461,808,888,80,6,66,81
462,349,52,-297,48,689,704
463,714,857,143,13,129,144
464,288,288,0,1,1,1
465,554,495,-59,62,927,942
466,397,543,146,11,132,147
467,535,138,-397,41,589,604
468,348,51,-297,48,689,704
469,623,452,-171,55,815,830
470,645,83,-562,30,424,439
471,171,504,333,24,319,334
472,684,430,-254,49,732,747
473,292,928,636,42,622,637
474,47,389,342,24,328,343
475,694,64,-630,25,356,371
476,522,496,-26,64,960,975
477,757,90,-667,24,319,334
478,669,872,203,16,189,204
479,810,641,-169,56,817,832
480,607,159,-448,36,538,553
481,334,744,410,28,396,411
482,795,374,-421,39,565,580
483,408,252,-156,55,830,845
484,821,411,-410,40,576,591
485,821,314,-507,34,479,494
486,221,383,162,12,148,163
487,376,636,260,18,246,261
488,137,751,614,41,600,615
489,166,273,107,10,93,108
490,154,26,-128,56,858,873
491,114,434,320,21,306,321
492,540,593,53,6,39,54
493,808,861,53,6,39,54
494,993,280,-713,22,273,288
495,152,658,506,34,492,507
496,959,15,-944,5,42,57
497,690,653,-37,63,949,964
498,189,360,171,14,157,172
499,150,868,718,48,704,719
500,873,62,-811,15,175,190
501,490,754,264,18,250,265
502,164,88,-76,60,910,925
503,909,950,41,5,27,42
504,336,718,382,27,368,383
505,608,163,-445,38,541,556
506,941,460,-481,36,505,520
507,360,768,408,27,394,409
508,561,633,72,6,58,73
509,681,481,-200,51,786,801
510,971,889,-82,60,904,919
511,764,738,-26,64,960,975
512,789,733,-56,60,930,945
513,857,396,-461,37,525,540
514,644,910,266,19,252,267
515,234,889,655,45,641,656
516,268,808,540,36,526,541
517,223,504,281,20,267,282
518,587,223,-364,42,622,637
519,743,902,159,14,145,160
520,16,400,384,25,370,385
521,892,978,86,8,72,87
522,382,135,-247,49,739,754
523,162,931,769,50,755,770
524,171,626,455,32,441,456
525,892,923,31,6,17,32
526,785,723,-62,61,924,939
527,649,570,-79,60,907,922
528,130,539,409,28,395,410
529,85,870,785,51,771,786
530,300,465,165,13,151,166
531,444,728,284,20,270,285
532,396,540,144,10,130,145
533,990,177,-813,15,173,188
534,692,358,-334,44,652,667
535,997,322,-675,23,311,326
536,339,191,-148,55,838,853
537,810,365,-445,38,541,556
538,386,106,-280,46,706,721
539,886,992,106,9,92,107
540,376,409,33,4,19,34
541,154,598,444,30,430,445
542,772,745,-27,64,959,974
543,787,69,-718,20,268,283
544,671,606,-65,62,921,936
545,203,204,1,2,2,2
546,40,744,704,45,690,705
547,656,197,-459,37,527,542
548,151,647,496,32,482,497
549,350,282,-68,60,918,933
550,326,285,-41,64,945,960
551,976,379,-597,28,389,404
552,182,660,478,33,464,479
553,330,688,358,25,344,359
554,155,174,19,4,5,20
555,806,909,103,10,89,104
556,541,491,-50,62,936,951
557,83,37,-46,62,940,955
558,655,598,-57,63,929,944
559,793,222,-571,30,415,430
560,459,943,484,32,470,485
561,165,718,553,37,539,554
562,209,498,289,20,275,290
563,735,283,-452,36,534,549
564,150,111,-39,62,947,962
565,688,194,-494,34,492,507
566,549,658,109,10,95,110
567,460,60,-400,39,586,601
568,649,719,70,7,56,71
569,284,122,-162,55,824,839
570,651,42,-609,28,377,392
571,406,852,446,31,432,447
572,102,504,402,27,388,403
573,737,806,69,7,55,70
574,448,501,53,6,39,54
575,589,941,352,23,338,353
576,736,753,17,3,3,18
577,717,854,137,11,123,138
578,629,159,-470,35,516,531
579,769,454,-315,46,671,686
580,124,860,736,47,722,737
581,495,653,158,13,144,159
582,480,425,-55,61,931,946
583,922,992,70,7,56,71
584,926,890,-36,62,950,965
585,149,972,823,55,809,824
586,42,189,147,12,133,148
587,703,465,-238,50,748,763
588,401,797,396,27,382,397
589,908,446,-462,36,524,539
590,829,871,42,5,28,43
591,690,573,-117,58,869,884
592,693,786,93,9,79,94
593,825,83,-742,18,244,259
594,8,701,693,46,679,694
595,927,997,70,7,56,71
596,550,540,-10,65,976,991
597,928,79,-849,13,137,152
598,20,232,212,15,198,213
599,288,695,407,29,393,408
600,72,449,377,26,363,378
601,683,140,-543,31,443,458
602,262,427,165,13,151,166
603,177,265,88,7,74,89
604,683,888,205,16,191,206
605,560,222,-338,44,648,663
606,456,709,253,19,239,254
607,953,137,-816,13,170,185
608,617,572,-45,63,941,956
609,413,486,73,7,59,74
610,759,93,-666,24,320,335
611,247,556,309,22,295,310
612,375,927,552,36,538,553
613,467,482,15,5,9,16
614,89,183,94,9,80,95
615,224,944,720,46,706,721
616,379,78,-301,47,685,700
617,703,869,166,13,152,167
618,942,185,-757,18,229,244
619,120,503,383,28,369,384
620,217,323,106,9,92,107
621,281,520,239,19,225,240
622,898,121,-777,18,209,224
623,752,232,-520,31,466,481
624,348,495,147,12,133,148
625,594,454,-140,56,846,861
626,116,114,-2,65,984,999
627,642,599,-43,63,943,958
628,902,479,-423,38,563,578
629,714,254,-460,36,526,541
630,253,299,46,6,32,47
631,938,133,-805,15,181,196
632,121,75,-46,62,940,955
633,461,558,97,8,83,98
634,782,374,-408,38,578,593
635,463,588,125,11,111,126
636,261,963,702,47,688,703
637,458,978,520,34,506,521
638,25,475,450,30,436,451
639,855,988,133,11,119,134
640,423,331,-92,59,894,909
641,651,674,23,5,9,24
642,548,165,-383,41,603,618
643,615,555,-60,61,926,941
644,891,370,-521,34,465,480
645,447,783,336,22,322,337
646,405,116,-289,48,697,712
647,48,655,607,42,593,608
648,135,946,811,54,797,812
649,886,341,-545,32,441,456
650,406,687,281,20,267,282
651,862,196,-666,24,320,335
652,244,977,733,49,719,734
653,844,841,-3,65,983,998
654,817,684,-133,57,853,868
655,254,464,210,15,196,211
656,747,909,162,12,148,163
657,392,389,-3,65,983,998
658,35,220,185,14,171,186
659,41,636,595,40,581,596
660,270,130,-140,56,846,861
661,132,826,694,46,680,695
662,709,118,-591,28,395,410
663,131,385,254,19,240,255
664,657,743,86,8,72,87
665,601,83,-518,32,468,483
666,451,829,378,26,364,379
667,41,937,896,57,882,897
668,326,847,521,35,507,522
669,883,476,-407,39,579,594
670,853,34,-819,14,167,182
671,866,0,-866,11,120,135
672,2,944,942,62,928,943
673,780,188,-592,27,394,409
674,956,960,4,2,2,5
675,687,537,-150,55,836,851
676,526,317,-209,53,777,792
677,891,334,-557,31,429,444
678,560,398,-162,55,824,839
679,444,864,420,28,406,421
680,55,243,188,14,174,189
681,268,529,261,19,247,262
682,814,412,-402,40,584,599
683,736,389,-347,44,639,654
684,671,148,-523,33,463,478
685,239,159,-80,59,906,921
686,338,960,622,42,608,623
687,959,276,-683,23,303,318
688,272,602,330,23,316,331
689,500,221,-279,47,707,722
690,108,573,465,31,451,466
691,475,958,483,33,469,484
692,275,994,719,49,705,720
693,406,729,323,23,309,324
694,709,77,-632,24,354,369
695,823,930,107,10,93,108
696,769,197,-572,29,414,429
697,507,511,4,2,2,5
698,792,471,-321,46,665,680
699,56,408,352,23,338,353
700,104,361,257,18,243,258
701,59,560,501,34,487,502
702,670,953,283,21,269,284
703,897,487,-410,40,576,591
704,355,154,-201,54,785,800
705,880,506,-374,41,612,627
706,847,374,-473,37,513,528
707,701,994,293,21,279,294
708,244,861,617,41,603,618
709,131,776,645,43,631,646
710,490,408,-82,60,904,919
711,755,583,-172,54,814,829
712,384,92,-292,46,694,709
713,625,426,-199,52,787,802
714,178,309,131,11,117,132
715,501,921,420,28,406,421
716,849,82,-767,17,219,234
717,965,136,-829,14,157,172
718,446,862,416,27,402,417
719,955,557,-398,40,588,603
720,373,395,22,4,8,23
721,624,258,-366,42,620,635
722,314,528,214,16,200,215
723,708,684,-24,62,962,977
724,812,336,-476,35,510,525
725,39,832,793,52,779,794
726,744,764,20,3,6,21
727,748,122,-626,26,360,375
728,285,897,612,40,598,613
729,568,121,-447,37,539,554
730,911,94,-817,15,169,184
731,278,478,200,14,186,201
732,614,681,67,7,53,68
733,386,252,-134,56,852,867
734,646,290,-356,42,630,645
735,898,374,-524,32,462,477
736,563,239,-324,44,662,677
737,9,72,63,8,49,64
738,814,867,53,6,39,54
739,921,742,-179,54,807,822
740,513,867,354,24,340,355
741,90,690,600,39,586,601
742,685,517,-168,53,818,833
743,370,806,436,29,422,437
744,158,996,838,55,824,839
745,25,984,959,64,945,960
746,513,888,375,27,361,376
747,837,101,-736,18,250,265
748,426,523,97,8,83,98
749,95,131,36,4,22,37
750,159,464,305,21,291,306
751,536,458,-78,60,908,923
752,295,708,413,29,399,414
753,680,243,-437,38,549,564
754,361,981,620,41,606,621
755,135,409,274,19,260,275
756,348,287,-61,62,925,940
757,184,90,-94,59,892,907
758,105,558,453,31,439,454
759,254,954,700,46,686,701
760,108,801,693,46,679,694
761,423,660,237,18,223,238
762,460,723,263,20,249,264
763,647,226,-421,39,565,580
764,255,171,-84,59,902,917
765,45,343,298,21,284,299
766,348,253,-95,59,891,906
767,788,289,-499,34,487,502
768,70,391,321,22,307,322
769,379,165,-214,51,772,787
770,548,290,-258,49,728,743
771,689,622,-67,61,919,934
772,813,300,-513,34,473,488
773,11,972,961,62,947,962
774,525,169,-356,42,630,645
775,695,700,5,3,3,6
776,120,851,731,49,717,732
777,144,187,43,6,29,44
778,614,872,258,18,244,259
779,440,361,-79,60,907,922
780,248,328,80,6,66,81
781,441,844,403,28,389,404
782,430,144,-286,47,700,715
783,825,955,130,10,116,131
784,687,65,-622,26,364,379
785,792,813,21,4,7,22
786,503,168,-335,44,651,666
787,279,421,142,12,128,143
788,813,913,100,8,86,101
789,521,69,-452,36,534,549
790,82,294,212,15,198,213
791,9,849,840,54,826,841
792,550,117,-433,39,553,568
793,326,149,-177,55,809,824
794,689,375,-314,46,672,687
795,873,33,-840,11,146,161
796,152,929,777,51,763,778
797,987,151,-836,12,150,165
798,582,632,50,5,36,51
799,41,933,892,58,878,893
800,588,219,-369,43,617,632
801,990,953,-37,63,949,964
802,36,858,822,54,808,823
803,203,297,94,9,80,95
804,294,585,291,21,277,292
805,609,719,110,10,96,111
806,766,269,-497,35,489,504
807,109,420,311,23,297,312
808,115,181,66,6,52,67
809,778,500,-278,47,708,723
810,248,301,53,6,39,54
811,363,424,61,7,47,62
812,819,884,65,6,51,66
813,268,186,-82,60,904,919
814,984,310,-674,23,312,327
815,145,766,621,42,607,622
816,399,466,67,7,53,68
817,624,96,-528,31,458,473
818,218,948,730,48,716,731
819,998,256,-742,18,244,259
820,218,300,82,7,68,83
821,631,286,-345,45,641,656
822,711,165,-546,31,440,455
823,48,788,740,48,726,741
824,529,133,-396,40,590,605
825,576,222,-354,43,632,647
826,669,766,97,8,83,98
827,3,577,574,39,560,575
828,67,835,768,49,754,769
829,683,778,95,10,81,96
830,876,586,-290,47,696,711
831,654,287,-367,42,619,634
832,598,225,-373,42,613,628
833,970,904,-66,61,920,935
834,604,65,-539,32,447,462
835,274,69,-205,53,781,796
836,28,193,165,13,151,166
837,342,337,-5,65,981,996
838,215,420,205,16,191,206
839,519,10,-509,34,477,492
840,236,906,670,45,656,671
841,445,802,357,25,343,358
842,989,530,-459,37,527,542
843,93,2,-91,60,895,910
844,426,970,544,35,530,545
845,169,205,36,4,22,37
846,381,401,20,3,6,21
847,437,936,499,34,485,500
848,255,487,232,16,218,233
849,391,670,279,21,265,280
850,742,490,-252,49,734,749
851,494,275,-219,52,767,782
852,252,893,641,42,627,642
853,570,137,-433,39,553,568
854,291,590,299,22,285,300
855,42,998,956,62,942,957
856,989,666,-323,45,663,678
857,517,657,140,11,126,141
858,901,914,13,4,7,14
859,534,477,-57,63,929,944
860,792,39,-753,19,233,248
861,46,54,8,2,2,9
862,70,977,907,60,893,908
863,934,979,45,6,31,46
864,833,340,-493,35,493,508
865,903,452,-451,37,535,550
866,668,120,-548,30,438,453
867,168,950,782,52,768,783
868,552,30,-522,33,464,479
869,516,375,-141,57,845,860
870,390,185,-205,53,781,796
871,964,217,-747,19,239,254
872,994,538,-456,35,530,545
873,423,550,127,12,113,128
874,489,503,14,4,8,15
875,349,293,-56,60,930,945
876,509,755,246,18,232,247
877,351,639,288,19,274,289
878,206,641,435,30,421,436
879,351,30,-321,46,665,680
880,740,129,-611,27,375,390
881,560,991,431,31,417,432
882,110,262,152,11,138,153
883,330,745,415,30,401,416
884,808,717,-91,60,895,910
885,473,743,270,20,256,271
886,600,400,-200,51,786,801
887,43,187,144,10,130,145
888,35,167,132,10,118,133
889,321,604,283,21,269,284
890,835,305,-530,32,456,471
891,516,790,274,19,260,275
892,855,689,-166,54,820,835
893,791,864,73,7,59,74
894,187,459,272,18,258,273
895,542,19,-523,33,463,478
896,95,19,-76,60,910,925
897,736,278,-458,37,528,543
898,157,167,10,3,4,11
899,175,594,419,29,405,420
900,842,229,-613,27,373,388
901,997,982,-15,64,971,986
902,12,709,697,46,683,698
903,750,671,-79,60,907,922
904,77,986,909,60,895,910
905,389,703,314,22,300,315
906,853,494,-359,42,627,642
907,181,568,387,27,373,388
908,636,928,292,20,278,293
909,840,72,-768,16,218,233
910,609,837,228,16,214,229
911,131,394,263,20,249,264
912,25,470,445,31,431,446
913,159,521,362,25,348,363
914,501,498,-3,65,983,998
915,685,501,-184,52,802,817
916,693,378,-315,46,671,686
917,258,389,131,11,117,132
918,88,188,100,8,86,101
919,307,452,145,11,131,146
920,173,547,374,26,360,375
921,73,45,-28,63,958,973
922,263,436,173,14,159,174
923,169,552,383,28,369,384
924,456,956,500,33,486,501
925,104,18,-86,59,900,915
926,40,8,-32,62,954,969
927,841,936,95,10,81,96
928,728,833,105,9,91,106
929,854,744,-110,58,876,891
930,993,162,-831,13,155,170
931,987,275,-712,19,274,289
932,67,988,921,60,907,922
933,281,321,40,4,26,41
934,376,595,219,17,205,220
935,75,676,601,40,587,602
936,136,700,564,37,550,565
937,631,594,-37,63,949,964
938,792,34,-758,17,228,243
939,819,356,-463,36,523,538
940,709,323,-386,41,600,615
941,490,677,187,15,173,188
942,931,765,-166,54,820,835
943,581,767,186,14,172,187
944,377,423,46,6,32,47
945,838,730,-108,58,878,893
946,360,3,-357,43,629,644
947,245,732,487,34,473,488
948,527,906,379,27,365,380
949,893,257,-636,25,350,365
950,359,905,546,36,532,547
951,879,911,32,3,18,33
952,403,684,281,20,267,282
953,402,908,506,34,492,507
954,417,2,-415,39,571,586
955,366,597,231,18,217,232
956,964,725,-239,50,747,762
957,318,295,-23,63,963,978
958,954,294,-660,23,326,341
959,139,663,524,35,510,525
960,255,275,20,3,6,21
961,663,441,-222,51,764,779
962,365,29,-336,43,650,665
963,907,208,-699,22,287,302
964,286,596,310,22,296,311
965,307,430,123,11,109,124
966,642,895,253,19,239,254
967,337,13,-324,44,662,677
968,386,872,486,33,472,487
969,585,502,-83,60,903,918
970,429,558,129,10,115,130
971,951,14,-937,8,49,64
972,823,581,-242,50,744,759
973,660,536,-124,57,862,877
974,126,90,-36,62,950,965
975,160,809,649,43,635,650
976,569,146,-423,38,563,578
977,139,491,352,23,338,353
978,220,894,674,44,660,675
979,335,10,-325,45,661,676
980,638,759,121,10,107,122
981,556,17,-539,32,447,462
982,646,261,-385,42,601,616
983,110,637,527,37,513,528
984,406,176,-230,50,756,771
985,705,79,-626,26,360,375
986,367,246,-121,59,865,880
987,233,680,447,32,433,448
988,922,246,-676,22,310,325
989,919,102,-817,15,169,184
990,183,973,790,52,776,791
991,828,449,-379,42,607,622
992,92,880,788,51,774,789
993,917,89,-828,13,158,173
994,797,932,135,12,121,136
995,792,555,-237,51,749,764
996,472,222,-250,50,736,751
997,336,803,467,32,453,468
998,799,426,-373,42,613,628
999,253,219,-34,63,952,967
1000,477,446,-31,63,955,970
1001,328,565,237,18,223,238
1002,123,839,716,47,702,717
1003,548,739,191,16,177,192
1004,285,739,454,31,440,455
1005,367,939,572,38,558,573
1006,552,622,70,7,56,71
1007,395,503,108,9,94,109
1008,298,506,208,14,194,209
1009,617,718,101,9,87,102
1010,79,152,73,7,59,74
1011,771,968,197,15,183,198
1012,54,188,134,11,120,135
1013,280,350,70,7,56,71
1014,490,355,-135,56,851,866
1015,555,481,-74,61,912,927
1016,835,800,-35,63,951,966
1017,435,703,268,19,254,269
1018,175,894,719,49,705,720
1019,991,226,-765,18,221,236
1020,782,877,95,10,81,96
1021,596,652,56,5,42,57
1022,429,906,477,33,463,478
1023,541,706,165,13,151,166
1024,212,983,771,51,757,772
1025,144,125,-19,64,967,982
1026,253,934,681,45,667,682
1027,3,824,821,54,807,822
1028,561,208,-353,44,633,648
1029,140,3,-137,58,849,864
1030,490,882,392,26,378,393
1031,280,237,-43,63,943,958
1032,328,691,363,26,349,364
1033,291,146,-145,57,841,856
1034,890,368,-522,33,464,479
1035,750,190,-560,29,426,441
1036,348,111,-237,51,749,764
1037,522,979,457,31,443,458
1038,329,500,171,14,157,172
1039,690,749,59,7,45,60
1040,787,311,-476,35,510,525
1041,120,296,176,12,162,177
1042,122,919,797,53,783,798
1043,784,973,189,15,175,190
1044,686,608,-78,60,908,923
1045,172,711,539,37,525,540
1046,166,160,-6,64,980,995
1047,419,175,-244,49,742,757
1048,831,250,-581,29,405,420
1049,627,505,-122,58,864,879
1050,286,165,-121,59,865,880
1051,624,720,96,7,82,97
1052,461,724,263,20,249,264
1053,612,250,-362,43,624,639
1054,895,15,-880,9,106,121
1055,306,342,36,4,22,37
1056,698,30,-668,23,318,333
1057,963,50,-913,9,73,88
1058,275,857,582,39,568,583
1059,47,12,-35,63,951,966
1060,136,45,-91,60,895,910
1061,91,899,808,52,794,809
1062,829,645,-184,52,802,817
1063,188,676,488,32,474,489
1064,945,54,-891,10,95,110
1065,427,483,56,5,42,57
1066,214,500,286,21,272,287
1067,934,546,-388,40,598,613
1068,855,85,-770,17,216,231
1069,976,710,-266,49,720,735
1070,958,619,-339,44,647,662
1071,201,853,652,43,638,653
1072,635,93,-542,31,444,459
1073,711,428,-283,48,703,718
1074,250,31,-219,52,767,782
1075,420,682,262,19,248,263
1076,956,511,-445,38,541,556
1077,21,66,45,6,31,46
1078,503,345,-158,55,828,843
1079,879,460,-419,39,567,582
1080,160,492,332,23,318,333
1081,322,321,-1,66,985,1000
1082,965,686,-279,47,707,722
1083,592,286,-306,46,680,695
1084,624,384,-240,49,746,761
1085,817,112,-705,22,281,296
1086,695,863,168,12,154,169
1087,815,692,-123,58,863,878
1088,484,140,-344,42,642,657
1089,285,496,211,16,197,212
1090,43,748,705,46,691,706
1091,468,520,52,5,38,53
1092,232,669,437,30,423,438
1093,924,12,-912,7,74,89
1094,141,865,724,47,710,725
1095,91,67,-24,62,962,977
1096,703,100,-603,28,383,398
1097,124,806,682,45,668,683
1098,422,989,567,39,553,568
1099,539,236,-303,46,683,698
1100,884,262,-622,26,364,379
1101,344,646,302,22,288,303
1102,191,562,371,26,357,372
1103,843,215,-628,25,358,373
1104,109,628,519,36,505,520
1105,199,512,313,22,299,314
1106,7,629,622,42,608,623
1107,233,986,753,49,739,754
1108,932,890,-42,63,944,959
1109,636,206,-430,38,556,571
1110,658,442,-216,50,770,785
1111,329,663,334,24,320,335
1112,871,415,-456,35,530,545
1113,124,733,609,40,595,610
1114,795,480,-315,46,671,686
1115,105,457,352,23,338,353
1116,448,938,490,33,476,491
1117,743,157,-586,29,400,415
1118,5,88,83,8,69,84
1119,391,776,385,26,371,386
1120,104,555,451,31,437,452
1121,626,31,-595,28,391,406
1122,722,223,-499,34,487,502
1123,856,470,-386,41,600,615
1124,871,8,-863,11,123,138
1125,530,982,452,30,438,453
1126,373,621,248,17,234,249
1127,333,352,19,4,5,20
1128,293,528,235,18,221,236
1129,692,887,195,15,181,196
1130,837,904,67,7,53,68
1131,379,732,353,24,339,354
1132,980,956,-24,62,962,977
1133,920,750,-170,55,816,831
1134,631,642,11,4,5,12
1135,553,60,-493,35,493,508
1136,760,652,-108,58,878,893
1137,939,233,-706,21,280,295
1138,403,562,159,14,145,160
1139,227,321,94,9,80,95
1140,158,364,206,16,192,207
1141,462,885,423,30,409,424
1142,800,275,-525,33,461,476
1143,52,810,758,50,744,759
1144,312,612,300,21,286,301
1145,76,761,685,46,671,686
1146,521,340,-181,54,805,820
1147,327,938,611,41,597,612
1148,184,662,478,33,464,479
1149,897,225,-672,22,314,329
1150,534,193,-341,44,645,660
1151,803,317,-486,34,500,515
1152,109,30,-79,60,907,922
1153,248,719,471,33,457,472
1154,925,372,-553,32,433,448
1155,899,47,-852,11,134,149
1156,199,902,703,48,689,704
1157,581,386,-195,53,791,806
1158,778,882,104,8,90,105
1159,234,442,208,14,194,209
1160,821,994,173,14,159,174
1161,399,253,-146,56,840,855
1162,563,164,-399,40,587,602
1163,886,4,-882,10,104,119
1164,275,387,112,8,98,113
1165,90,703,613,41,599,614
1166,822,605,-217,53,769,784
1167,91,799,708,46,694,709
1168,199,83,-116,57,870,885
1169,300,995,695,47,681,696
1170,321,690,369,25,355,370
1171,358,665,307,22,293,308
1172,879,498,-381,42,605,620
1173,249,759,510,35,496,511
1174,381,786,405,28,391,406
1175,751,169,-582,28,404,419
1176,468,357,-111,58,875,890
1177,697,575,-122,58,864,879
1178,908,79,-829,14,157,172
1179,322,135,-187,54,799,814
1180,51,14,-37,63,949,964
1181,204,121,-83,60,903,918
1182,703,787,84,7,70,85
1183,488,942,454,31,440,455
1184,155,827,672,43,658,673
1185,164,877,713,47,699,714
1186,887,698,-189,54,797,812
1187,21,826,805,53,791,806
1188,885,936,51,6,37,52
1189,687,692,5,3,3,6
1190,102,302,200,14,186,201
1191,645,31,-614,26,372,387
1192,203,538,335,25,321,336
1193,37,244,207,17,193,208
1194,439,928,489,33,475,490
1195,80,987,907,60,893,908
1196,44,916,872,56,858,873
1197,569,845,276,19,262,277
1198,413,390,-23,63,963,978
1199,441,656,215,17,201,216
1200,318,814,496,32,482,497
1201,985,632,-353,44,633,648
1202,36,537,501,34,487,502
1203,424,701,277,20,263,278
1204,129,224,95,10,81,96
1205,250,815,565,38,551,566
1206,720,182,-538,32,448,463
1207,461,60,-401,41,585,600
1208,275,525,250,18,236,251
1209,664,220,-444,37,542,557
1210,416,427,11,4,5,12
1211,69,676,607,42,593,608
1212,715,34,-681,24,305,320
1213,846,800,-46,62,940,955
1214,255,612,357,25,343,358
1215,80,835,755,50,741,756
1216,0,724,724,47,710,725
1217,89,653,564,37,550,565
1218,369,472,103,10,89,104
1219,843,525,-318,45,668,683
1220,26,358,332,23,318,333
1221,589,196,-393,42,593,608
1222,874,434,-440,36,546,561
1223,477,271,-206,52,780,795
1224,604,35,-569,31,417,432
1225,486,40,-446,37,540,555
1226,585,152,-433,39,553,568
1227,319,762,443,31,429,444
1228,959,678,-281,49,705,720
1229,672,891,219,17,205,220
1230,638,595,-43,63,943,958
1231,129,942,813,54,799,814
1232,444,454,10,3,4,11
1233,473,607,134,11,120,135
1234,345,407,62,7,48,63
1235,884,741,-143,56,843,858
1236,664,106,-558,30,428,443
1237,298,384,86,8,72,87
1238,855,368,-487,34,499,514
1239,166,273,107,10,93,108
1240,102,772,670,45,656,671
1241,226,262,36,4,22,37
1242,229,932,703,48,689,704
1243,638,961,323,23,309,324
1244,49,858,809,53,795,810
1245,657,403,-254,49,732,747
1246,634,44,-590,28,396,411
1247,959,558,-401,41,585,600
1248,365,304,-61,62,925,940
1249,707,472,-235,51,751,766
1250,875,797,-78,60,908,923
1251,367,685,318,23,304,319
1252,604,562,-42,63,944,959
1253,310,253,-57,63,929,944
1254,300,19,-281,49,705,720
1255,956,739,-217,53,769,784
1256,377,511,134,11,120,135
1257,783,706,-77,61,909,924
1258,692,925,233,17,219,234
1259,99,95,-4,64,982,997
1260,835,101,-734,19,252,267
1261,178,425,247,19,233,248
1262,240,990,750,50,736,751
1263,892,705,-187,54,799,814
1264,904,296,-608,26,378,393
1265,490,173,-317,46,669,684
1266,20,787,767,52,753,768
1267,829,498,-331,45,655,670
1268,445,238,-207,52,779,794
1269,223,450,227,17,213,228
1270,209,689,480,31,466,481
1271,188,580,392,26,378,393
1272,641,617,-24,62,962,977
1273,543,103,-440,36,546,561
1274,427,62,-365,43,621,636
1275,838,107,-731,20,255,270
1276,187,487,300,21,286,301
1277,652,853,201,15,187,202
1278,525,538,13,4,7,14
1279,596,903,307,22,293,308
1280,277,830,553,37,539,554
1281,532,803,271,21,257,272
1282,414,298,-116,57,870,885
1283,624,938,314,22,300,315
1284,397,102,-295,46,691,706
1285,15,215,200,14,186,201
1286,494,102,-392,39,594,609
1287,225,531,306,21,292,307
1288,662,567,-95,59,891,906
1289,36,723,687,47,673,688
1290,877,968,91,9,77,92
1291,133,267,134,11,120,135
1292,619,613,-6,64,980,995
1293,140,234,94,9,80,95
1294,537,216,-321,46,665,680
1295,769,201,-568,28,418,433
1296,119,918,799,54,785,800
1297,97,463,366,26,352,367
1298,198,900,702,47,688,703
1299,829,662,-167,54,819,834
1300,272,744,472,31,458,473
1301,163,138,-25,65,961,976
1302,539,562,23,5,9,24
1303,696,805,109,10,95,110
1304,331,571,240,16,226,241
1305,617,487,-130,57,856,871
1306,21,85,64,5,50,65
1307,710,49,-661,24,325,340
1308,289,295,6,3,4,7
1309,48,229,181,14,167,182
1310,435,847,412,28,398,413
1311,820,621,-199,52,787,802
1312,920,734,-186,54,800,815
1313,133,70,-63,61,923,938
1314,516,640,124,10,110,125
1315,641,796,155,13,141,156
1316,690,779,89,8,75,90
1317,846,98,-748,18,238,253
1318,652,210,-442,38,544,559
1319,181,973,792,51,778,793
1320,352,996,644,42,630,645
1321,821,115,-706,21,280,295
1322,894,112,-782,16,204,219
1323,196,934,738,48,724,739
1324,224,148,-76,60,910,925
1325,737,43,-694,21,292,307
1326,637,326,-311,45,675,690
1327,389,587,198,15,184,199
1328,455,521,66,6,52,67
1329,412,793,381,27,367,382
1330,83,467,384,25,370,385
1331,620,807,187,15,173,188
1332,227,21,-206,52,780,795
1333,814,511,-303,46,683,698
1334,263,189,-74,61,912,927
1335,876,699,-177,55,809,824
1336,854,617,-237,51,749,764
1337,497,756,259,19,245,260
1338,729,642,-87,59,899,914
1339,71,905,834,54,820,835
1340,21,81,60,6,46,61
1341,148,59,-89,61,897,912
1342,300,567,267,20,253,268
1343,581,576,-5,65,981,996
1344,906,100,-806,14,180,195
1345,854,59,-795,16,191,206
1346,688,212,-476,35,510,525
1347,865,844,-21,64,965,980
1348,827,407,-420,38,566,581
1349,307,74,-233,52,753,768
1350,731,352,-379,42,607,622
1351,649,839,190,15,176,191
1352,880,769,-111,58,875,890
1353,2,170,168,12,154,169
1354,541,409,-132,56,854,869
1355,604,10,-594,28,392,407
1356,276,915,639,44,625,640
1357,430,84,-346,44,640,655
1358,316,890,574,39,560,575
1359,941,462,-479,35,507,522
1360,959,187,-772,16,214,229
1361,0,385,385,26,371,386
1362,581,790,209,15,195,210
1363,547,167,-380,41,606,621
1364,186,118,-68,60,918,933
1365,936,723,-213,52,773,788
1366,335,175,-160,54,826,841
1367,903,798,-105,60,881,896
1368,105,174,69,7,55,70
1369,662,635,-27,64,959,974
1370,793,626,-167,54,819,834
1371,247,204,-43,63,943,958
1372,266,442,176,12,162,177
1373,422,82,-340,43,646,661
1374,935,184,-751,18,235,250
1375,935,851,-84,59,902,917
1376,844,397,-447,37,539,554
1377,187,978,791,53,777,792
1378,4,763,759,51,745,760
1379,634,104,-530,32,456,471
1380,339,756,417,28,403,418
1381,837,627,-210,52,776,791
1382,999,126,-873,12,113,128
1383,973,687,-286,47,700,715
1384,988,473,-515,33,471,486
1385,2,687,685,46,671,686
1386,889,639,-250,50,736,751
1387,707,507,-200,51,786,801
1388,984,313,-671,23,315,330
1389,756,748,-8,63,978,993
1390,81,691,610,40,596,611
1391,40,155,115,10,101,116
1392,838,361,-477,36,509,524
1393,636,931,295,22,281,296
1394,382,303,-79,60,907,922
1395,201,252,51,6,37,52
1396,544,9,-535,31,451,466
1397,319,567,248,17,234,249
1398,874,547,-327,44,659,674
1399,270,350,80,6,66,81
1400,172,640,468,31,454,469
1401,601,714,113,9,99,114
1402,365,399,34,4,20,35
1403,281,649,368,24,354,369
1404,362,308,-54,61,932,947
1405,99,462,363,26,349,364
1406,464,454,-10,65,976,991
1407,512,11,-501,34,485,500
1408,632,606,-26,64,960,975
1409,547,810,263,20,249,264
1410,132,258,126,11,112,127
1411,369,560,191,16,177,192
1412,946,331,-615,26,371,386
1413,317,961,644,42,630,645
1414,480,781,301,22,287,302
1415,222,798,576,37,562,577
1416,158,701,543,38,529,544
1417,189,126,-63,61,923,938
1418,805,151,-654,24,332,347
1419,350,422,72,6,58,73
1420,155,336,181,14,167,182
1421,756,153,-603,28,383,398
1422,771,137,-634,26,352,367
1423,691,682,-9,66,977,992
1424,972,131,-841,14,145,160
1425,701,222,-479,35,507,522
1426,282,624,342,24,328,343
1427,938,275,-663,23,323,338
1428,359,630,271,21,257,272
1429,745,533,-212,51,774,789
1430,599,299,-300,46,686,701
1431,579,94,-485,35,501,516
1432,436,942,506,34,492,507
1433,298,282,-16,63,970,985
1434,706,921,215,17,201,216
1435,308,915,607,42,593,608
1436,911,658,-253,50,733,748
1437,363,245,-118,57,868,883
1438,273,316,43,6,29,44
1439,636,998,362,25,348,363
1440,418,423,5,3,3,6
1441,601,174,-427,39,559,574
1442,197,541,344,23,330,345
1443,989,657,-332,44,654,669
1444,776,508,-268,48,718,733
1445,747,729,-18,64,968,983
1446,118,928,810,53,796,811
1447,445,355,-90,60,896,911
1448,130,296,166,13,152,167
1449,48,651,603,41,589,604
1450,895,774,-121,59,865,880
1451,572,488,-84,59,902,917
1452,697,133,-564,29,422,437
1453,116,255,139,12,125,140
1454,999,567,-432,37,554,569
1455,998,762,-236,50,750,765
1456,684,835,151,13,137,152
1457,320,141,-179,54,807,822
1458,458,636,178,13,164,179
1459,914,756,-158,55,828,843
1460,409,211,-198,52,788,803
1461,823,494,-329,46,657,672
1462,771,502,-269,49,717,732
1463,805,707,-98,59,888,903
1464,155,209,54,6,40,55
1465,937,617,-320,44,666,681
1466,155,347,192,13,178,193
1467,368,187,-181,54,805,820
1468,373,449,76,7,62,77
1469,583,943,360,24,346,361
1470,757,903,146,11,132,147
1471,215,709,494,34,480,495
1472,697,114,-583,28,403,418
1473,377,788,411,29,397,412
1474,670,305,-365,43,621,636
1475,244,806,562,37,548,563
1476,657,631,-26,64,960,975
1477,388,28,-360,41,626,641
1478,697,287,-410,40,576,591
1479,791,203,-588,28,398,413
1480,427,179,-248,48,738,753
1481,488,609,121,10,107,122
1482,801,260,-541,32,445,460
1483,884,883,-1,66,985,1000
1484,783,976,193,14,179,194
1485,845,518,-327,44,659,674
1486,981,39,-942,6,44,59
1487,531,420,-111,58,875,890
1488,829,55,-774,16,212,227
1489,546,761,215,17,201,216
1490,284,269,-15,64,971,986
1491,731,175,-556,30,430,445
1492,296,786,490,33,476,491
1493,528,648,120,9,106,121
1494,43,451,408,27,394,409
1495,940,455,-485,35,501,516
1496,822,815,-7,64,979,994
1497,940,761,-179,54,807,822
1498,567,595,28,4,14,29
1499,623,337,-286,47,700,715
1500,700,324,-376,40,610,625
1501,679,749,70,7,56,71
1502,838,500,-338,44,648,663
1503,673,930,257,18,243,258
1504,169,471,302,22,288,303
1505,46,464,418,28,404,419
1506,60,777,717,48,703,718
1507,425,5,-420,38,566,581
1508,770,439,-331,45,655,670
1509,137,542,405,28,391,406
1510,264,993,729,48,715,730
1511,616,918,302,22,288,303
1512,515,198,-317,46,669,684
1513,36,487,451,31,437,452
1514,71,440,369,25,355,370
1515,587,654,67,7,53,68
1516,21,385,364,25,350,365
1517,782,892,110,10,96,111
1518,915,382,-533,32,453,468
1519,106,615,509,35,495,510
1520,228,790,562,37,548,563
1521,384,78,-306,46,680,695
1522,642,330,-312,44,674,689
1523,922,398,-524,32,462,477
1524,207,688,481,32,467,482
1525,373,495,122,10,108,123
1526,798,27,-771,17,215,230
1527,691,999,308,21,294,309
1528,711,507,-204,52,782,797
1529,939,41,-898,9,88,103
1530,675,623,-52,61,934,949
1531,454,186,-268,48,718,733
1532,30,574,544,35,530,545
1533,98,319,221,17,207,222
1534,213,997,784,50,770,785
1535,828,598,-230,50,756,771
1536,238,478,240,16,226,241
1537,908,81,-827,14,159,174
1538,266,532,266,19,252,267
1539,969,133,-836,12,150,165
1540,493,225,-268,48,718,733
1541,790,992,202,15,188,203
1542,825,657,-168,53,818,833
1543,323,725,402,27,388,403
1544,631,510,-121,59,865,880
1545,171,333,162,12,148,163
1546,137,80,-57,63,929,944
1547,345,696,351,26,337,352
1548,256,465,209,15,195,210
1549,694,113,-581,29,405,420
1550,660,25,-635,26,351,366
1551,161,972,811,54,797,812
1552,415,816,401,27,387,402
1553,527,297,-230,50,756,771
1554,489,903,414,29,400,415
1555,901,550,-351,43,635,650
1556,813,959,146,11,132,147
1557,367,856,489,33,475,490
1558,393,463,70,7,56,71
1559,926,242,-684,22,302,317
1560,765,927,162,12,148,163
1561,748,446,-302,46,684,699
1562,883,94,-789,16,197,212
1563,620,515,-105,60,881,896
1564,951,790,-161,56,825,840
1565,561,218,-343,43,643,658
1566,768,666,-102,58,884,899
1567,825,560,-265,50,721,736
1568,628,221,-407,39,579,594
1569,565,847,282,20,268,283
1570,456,235,-221,52,765,780
1571,465,857,392,26,378,393
1572,306,913,607,42,593,608
1573,584,709,125,11,111,126
1574,785,853,68,6,54,69
1575,780,264,-516,32,470,485
1576,318,847,529,35,515,530
1577,398,469,71,8,57,72
1578,904,728,-176,53,810,825
1579,512,540,28,4,14,29
1580,669,807,138,11,124,139
1581,101,650,549,37,535,550
1582,378,663,285,21,271,286
1583,827,438,-389,41,597,612
1584,287,189,-98,59,888,903
1585,736,646,-90,60,896,911
1586,991,161,-830,13,156,171
1587,770,236,-534,31,452,467
1588,549,791,242,17,228,243
1589,366,578,212,15,198,213
1590,190,380,190,15,176,191
1591,162,645,483,33,469,484
1592,41,143,102,9,88,103
1593,951,761,-190,53,796,811
1594,511,258,-253,50,733,748
1595,727,369,-358,42,628,643
1596,4,401,397,28,383,398
1597,943,646,-297,48,689,704
1598,405,929,524,35,510,525
1599,334,7,-327,44,659,674
1600,31,573,542,37,528,543
1601,653,638,-15,64,971,986
1602,116,7,-109,59,877,892
1603,453,477,24,3,10,25
1604,113,288,175,15,161,176
1605,895,153,-742,18,244,259
1606,139,357,218,16,204,219
1607,496,487,-9,66,977,992
1608,422,195,-227,51,759,774
1609,60,372,312,21,298,313
1610,564,581,17,3,3,18
1611,548,947,399,29,385,400
1612,934,569,-365,43,621,636
1613,764,600,-164,54,822,837
1614,481,977,496,32,482,497
1615,856,856,0,1,1,1
1616,606,262,-344,42,642,657
1617,319,375,56,5,42,57
1618,739,477,-262,48,724,739
1619,201,985,784,50,770,785
1620,655,583,-72,59,914,929
1621,448,786,338,23,324,339
1622,456,120,-336,43,650,665
1623,856,836,-20,63,966,981
1624,428,327,-101,59,885,900
1625,248,993,745,49,731,746
1626,100,719,619,42,605,620
1627,660,93,-567,29,419,434
1628,3,669,666,44,652,667
1629,579,281,-298,47,688,703
1630,167,367,200,14,186,201
1631,928,370,-558,30,428,443
1632,724,556,-168,53,818,833
1633,87,509,422,29,408,423
1634,31,524,493,34,479,494
1635,257,212,-45,63,941,956
1636,769,315,-454,36,532,547
1637,197,425,228,16,214,229
1638,341,258,-83,60,903,918
1639,621,404,-217,53,769,784
1640,960,772,-188,53,798,813
1641,143,779,636,42,622,637
1642,157,399,242,17,228,243
1643,200,66,-134,56,852,867
1644,844,523,-321,46,665,680
1645,355,903,548,36,534,549
1646,570,972,402,27,388,403
1647,392,812,420,28,406,421
1648,455,262,-193,54,793,808
1649,158,823,665,44,651,666
1650,592,97,-495,34,491,506
1651,717,386,-331,45,655,670
1652,694,868,174,14,160,175
1653,70,856,786,51,772,787
1654,177,117,-60,61,926,941
1655,618,546,-72,59,914,929
1656,724,770,46,6,32,47
1657,99,180,81,7,67,82
1658,129,993,864,55,850,865
1659,910,297,-613,27,373,388
1660,302,347,45,6,31,46
1661,755,473,-282,48,704,719
1662,759,784,25,4,11,26
1663,564,641,77,8,63,78
1664,821,342,-479,35,507,522
1665,93,560,467,32,453,468
1666,638,61,-577,30,409,424
1667,267,321,54,6,40,55
1668,870,368,-502,33,484,499
1669,901,918,17,3,3,18
1670,825,239,-586,29,400,415
1671,433,272,-161,56,825,840
1672,345,299,-46,62,940,955
1673,22,405,383,28,369,384
1674,342,713,371,26,357,372
1675,924,754,-170,55,816,831
1676,203,672,469,32,455,470
1677,273,983,710,47,696,711
1678,932,81,-851,12,135,150
1679,37,890,853,56,839,854
1680,48,868,820,53,806,821
1681,84,90,6,3,4,7
1682,870,579,-291,47,695,710
1683,545,257,-288,46,698,713
1684,371,619,248,17,234,249
1685,56,400,344,23,330,345
1686,271,982,711,48,697,712
1687,933,147,-786,16,200,215
1688,534,279,-255,49,731,746
1689,681,295,-386,41,600,615
1690,272,977,705,46,691,706
1691,218,506,288,19,274,289
1692,274,144,-130,57,856,871
1693,38,552,514,34,500,515
1694,466,301,-165,55,821,836
1695,919,59,-860,11,126,141
1696,279,722,443,31,429,444
1697,407,884,477,33,463,478
1698,343,904,561,37,547,562
1699,716,198,-518,32,468,483
1700,535,335,-200,51,786,801
1701,434,549,115,10,101,116
1702,266,542,276,19,262,277
1703,228,906,678,45,664,679
1704,333,725,392,26,378,393
1705,232,968,736,47,722,737
1706,820,327,-493,35,493,508
1707,273,916,643,43,629,644
1708,706,783,77,8,63,78
1709,708,92,-616,25,370,385
1710,519,520,1,2,2,2
1711,336,155,-181,54,805,820
1712,568,524,-44,62,942,957
1713,862,92,-770,17,216,231
1714,767,496,-271,48,715,730
1715,862,39,-823,13,163,178
1716,209,869,660,43,646,661
1717,145,577,432,28,418,433
1718,463,395,-68,60,918,933
1719,207,497,290,20,276,291
1720,472,55,-417,40,569,584
1721,215,454,239,19,225,240
1722,776,469,-307,46,679,694
1723,351,577,226,16,212,227
1724,178,457,279,21,265,280
1725,536,66,-470,35,516,531
1726,910,724,-186,54,800,815
1727,52,571,519,36,505,520
1728,277,806,529,35,515,530
1729,227,835,608,39,594,609
1730,845,213,-632,24,354,369
1731,728,432,-296,45,690,705
1732,808,202,-606,27,380,395
1733,926,612,-314,46,672,687
1734,850,806,-44,62,942,957
1735,906,274,-632,24,354,369
1736,536,515,-21,64,965,980
1737,747,196,-551,30,435,450
1738,975,629,-346,44,640,655
1739,607,695,88,7,74,89
1740,915,985,70,7,56,71
1741,213,885,672,43,658,673
1742,285,868,583,40,569,584
1743,799,996,197,15,183,198
1744,292,3,-289,48,697,712
1745,161,87,-74,61,912,927
1746,719,636,-83,60,903,918
1747,717,145,-572,29,414,429
1748,129,343,214,16,200,215
1749,150,970,820,53,806,821
1750,660,463,-197,53,789,804
1751,660,870,210,15,196,211
1752,663,576,-87,59,899,914
1753,811,215,-596,27,390,405
1754,367,561,194,14,180,195
1755,54,61,7,4,5,8
1756,321,469,148,11,134,149
1757,72,394,322,22,308,323
1758,676,636,-40,61,946,961
1759,121,255,134,11,120,135
1760,792,858,66,6,52,67
1761,844,867,23,5,9,24
1762,119,648,529,35,515,530
1763,624,404,-220,51,766,781
1764,184,455,271,21,257,272
1765,600,243,-357,43,629,644
1766,17,626,609,40,595,610
1767,876,254,-622,26,364,379
1768,918,915,-3,65,983,998
1769,698,862,164,12,150,165
1770,332,815,483,33,469,484
1771,42,905,863,58,849,864
1772,988,370,-618,27,368,383
1773,538,539,1,2,2,2
1774,741,486,-255,49,731,746
1775,623,346,-277,48,709,724
1776,924,533,-391,40,595,610
1777,90,279,189,15,175,190
1778,240,53,-187,54,799,814
1779,607,969,362,25,348,363
1780,459,393,-66,61,920,935
1781,318,978,660,43,646,661
1782,570,396,-174,54,812,827
1783,737,526,-211,52,775,790
1784,224,214,-10,65,976,991
1785,91,690,599,41,585,600
1786,420,620,200,14,186,201
1787,162,112,-50,62,936,951
1788,448,504,56,5,42,57
1789,868,186,-682,23,304,319
1790,340,857,517,35,503,518
1791,993,688,-305,47,681,696
1792,886,584,-302,46,684,699
1793,337,898,561,37,547,562
1794,155,561,406,28,392,407
1795,219,186,-33,64,953,968
1796,56,407,351,26,337,352
1797,388,971,583,40,569,584
1798,725,858,133,11,119,134
1799,988,754,-234,51,752,767
1800,106,954,848,54,834,849
1801,11,13,2,2,2,3
1802,380,254,-126,57,860,875
1803,701,355,-346,44,640,655
1804,194,719,525,36,511,526
1805,443,984,541,37,527,542
1806,880,86,-794,16,192,207
1807,662,189,-473,37,513,528
1808,631,509,-122,58,864,879
1809,667,224,-443,38,543,558
1810,605,498,-107,59,879,894
1811,203,409,206,16,192,207
1812,777,254,-523,33,463,478
1813,245,273,28,4,14,29
1814,772,371,-401,41,585,600
1815,560,656,96,7,82,97
1816,824,261,-563,30,423,438
1817,560,909,349,25,335,350
1818,682,853,171,14,157,172
1819,960,342,-618,27,368,383
1820,787,323,-464,35,522,537
1821,240,822,582,39,568,583
1822,134,525,391,28,377,392
1823,249,934,685,46,671,686
1824,877,870,-7,64,979,994
1825,809,640,-169,56,817,832
1826,430,433,3,3,3,4
1827,688,80,-608,26,378,393
1828,928,375,-553,32,433,448
1829,165,196,31,6,17,32
1830,135,155,20,3,6,21
1831,93,261,168,12,154,169
1832,50,439,389,27,375,390
1833,236,457,221,17,207,222
1834,152,843,691,46,677,692
1835,507,984,477,33,463,478
1836,433,919,486,33,472,487
1837,78,41,-37,63,949,964
1838,373,540,167,14,153,168
1839,143,27,-116,57,870,885
1840,973,917,-56,60,930,945
1841,270,348,78,8,64,79
1842,32,539,507,35,493,508
1843,191,409,218,16,204,219
1844,266,553,287,22,273,288
1845,823,783,-40,61,946,961
1846,532,641,109,10,95,110
1847,232,139,-93,60,893,908
1848,468,500,32,3,18,33
1849,798,788,-10,65,976,991
1850,92,802,710,47,696,711
1851,323,642,319,24,305,320
1852,652,620,-32,62,954,969
1853,894,733,-161,56,825,840
1854,267,786,519,36,505,520
1855,426,910,484,32,470,485
1856,654,310,-344,42,642,657
1857,972,148,-824,12,162,177
1858,735,364,-371,42,615,630
1859,188,9,-179,54,807,822
1860,755,338,-417,40,569,584
1861,872,736,-136,55,850,865
1862,3,812,809,53,795,810
1863,634,552,-82,60,904,919
1864,872,474,-398,40,588,603
1865,854,830,-24,62,962,977
1866,430,136,-294,46,692,707
1867,360,357,-3,65,983,998
1868,693,666,-27,64,959,974
1869,232,932,700,46,686,701
1870,807,268,-539,32,447,462
1871,720,684,-36,62,950,965
1872,210,43,-167,54,819,834
1873,246,654,408,27,394,409
1874,261,169,-92,59,894,909
1875,857,83,-774,16,212,227
1876,914,296,-618,27,368,383
1877,148,121,-27,64,959,974
1878,740,544,-196,52,790,805
1879,961,118,-843,13,143,158
1880,543,10,-533,32,453,468
1881,322,489,167,14,153,168
1882,610,683,73,7,59,74
1883,975,953,-22,63,964,979
1884,97,3,-94,59,892,907
1885,247,361,114,9,100,115
1886,955,817,-138,57,848,863
1887,143,845,702,47,688,703
1888,599,750,151,13,137,152
1889,381,861,480,31,466,481
1890,163,88,-75,61,911,926
1891,645,297,-348,43,638,653
1892,544,786,242,17,228,243
1893,185,283,98,8,84,99
1894,143,537,394,27,380,395
1895,174,530,356,24,342,357
1896,552,788,236,17,222,237
1897,550,464,-86,59,900,915
1898,213,7,-206,52,780,795
1899,143,358,215,17,201,216
1900,422,416,-6,64,980,995
1901,80,46,-34,63,952,967
1902,648,508,-140,56,846,861
1903,55,768,713,47,699,714
1904,953,532,-421,39,565,580
1905,800,286,-514,33,472,487
1906,339,587,248,17,234,249
1907,77,829,752,48,738,753
1908,670,244,-426,39,560,575
1909,8,785,777,51,763,778
1910,447,45,-402,40,584,599
1911,653,448,-205,53,781,796
1912,500,949,449,30,435,450
1913,655,9,-646,24,340,355
1914,896,475,-421,39,565,580
1915,542,628,86,8,72,87
1916,327,424,97,8,83,98
1917,41,150,109,10,95,110
1918,964,704,-260,48,726,741
1919,711,379,-332,44,654,669
1920,649,774,125,11,111,126
1921,371,382,11,4,5,12
1922,586,443,-143,56,843,858
1923,356,698,342,24,328,343
1924,611,706,95,10,81,96
1925,121,106,-15,64,971,986
1926,778,769,-9,66,977,992
1927,248,61,-187,54,799,814
1928,852,655,-197,53,789,804
1929,130,65,-65,62,921,936
1930,298,474,176,12,162,177
1931,603,332,-271,48,715,730
1932,608,824,216,15,202,217
1933,379,752,373,26,359,374
1934,897,791,-106,59,880,895
1935,471,325,-146,56,840,855
1936,177,941,764,50,750,765
1937,611,420,-191,53,795,810
1938,570,893,323,23,309,324
1939,511,363,-148,55,838,853
1940,144,991,847,57,833,848
1941,763,22,-741,19,245,260
1942,745,79,-666,24,320,335
1943,571,46,-525,33,461,476
1944,458,93,-365,43,621,636
1945,227,464,237,18,223,238
1946,356,16,-340,43,646,661
1947,319,171,-148,55,838,853
1948,49,575,526,36,512,527
1949,262,298,36,4,22,37
1950,431,205,-226,51,760,775
1951,844,370,-474,36,512,527
1952,646,332,-314,46,672,687
1953,65,70,5,3,3,6
1954,693,327,-366,42,620,635
1955,241,852,611,41,597,612
1956,80,422,342,24,328,343
1957,407,367,-40,61,946,961
1958,306,327,21,4,7,22
1959,760,480,-280,46,706,721
1960,951,669,-282,48,704,719
1961,866,56,-810,15,176,191
1962,801,183,-618,27,368,383
1963,496,184,-312,44,674,689
1964,558,503,-55,61,931,946
1965,116,473,357,25,343,358
1966,569,695,126,11,112,127
1967,271,448,177,13,163,178
1968,254,714,460,31,446,461
1969,247,709,462,32,448,463
1970,172,530,358,25,344,359
1971,246,637,391,28,377,392
1972,670,887,217,16,203,218
1973,937,887,-50,62,936,951
1974,304,169,-135,56,851,866
1975,964,94,-870,10,116,131
1976,973,559,-414,39,572,587
1977,461,640,179,14,165,180
1978,362,142,-220,51,766,781
1979,294,222,-72,59,914,929
1980,430,779,349,25,335,350
1981,704,264,-440,36,546,561
1982,441,210,-231,50,755,770
1983,710,234,-476,35,510,525
1984,415,829,414,29,400,415
1985,469,644,175,15,161,176
1986,7,204,197,15,183,198
1987,790,48,-742,18,244,259
1988,783,354,-429,39,557,572
1989,186,126,-60,61,926,941
1990,619,170,-449,38,537,552
1991,964,938,-26,64,960,975
1992,572,804,232,16,218,233
1993,956,717,-239,50,747,762
1994,661,979,318,23,304,319
1995,873,619,-254,49,732,747
1996,680,841,161,12,147,162
1997,89,500,411,29,397,412
1998,755,822,67,7,53,68
1999,84,611,527,37,513,528
2000,216,461,245,18,231,246
2001,993,884,-109,59,877,892
2002,775,952,177,13,163,178
2003,891,557,-334,44,652,667
2004,367,413,46,6,32,47
2005,843,684,-159,55,827,842
2006,292,0,-292,46,694,709
2007,283,607,324,22,310,325
2008,473,609,136,10,122,137
2009,931,201,-730,20,256,271
2010,144,502,358,25,344,359
2011,208,764,556,37,542,557
2012,714,297,-417,40,569,584
2013,923,348,-575,29,411,426
2014,38,65,27,5,13,28
2015,234,617,383,28,369,384
2016,454,767,313,22,299,314
2017,602,237,-365,43,621,636
2018,331,622,291,21,277,292
2019,122,709,587,40,573,588
2020,789,715,-74,61,912,927
2021,470,438,-32,62,954,969
2022,270,340,70,7,56,71
2023,847,356,-491,35,495,510
2024,95,64,-31,63,955,970
2025,680,112,-568,28,418,433
2026,25,639,614,41,600,615
2027,426,72,-354,43,632,647
2028,518,584,66,6,52,67
2029,890,428,-462,36,524,539
2030,399,845,446,31,432,447
2031,687,461,-226,51,760,775
2032,127,270,143,13,129,144
2033,67,571,504,33,490,505
2034,905,287,-618,27,368,383
2035,200,794,594,39,580,595
2036,100,958,858,56,844,859
2037,198,175,-23,63,963,978
2038,107,882,775,52,761,776
2039,865,12,-853,12,133,148
2040,96,525,429,30,415,430
2041,507,781,274,19,260,275
2042,817,522,-295,46,691,706
2043,155,294,139,12,125,140
2044,782,791,9,3,3,10
2045,322,662,340,23,326,341
2046,809,568,-241,51,745,760
2047,689,620,-69,61,917,932
2048,112,415,303,23,289,304
2049,918,833,-85,60,901,916
2050,329,766,437,30,423,438
2051,587,702,115,10,101,116
2052,571,365,-206,52,780,795
2053,31,278,247,19,233,248
2054,593,146,-447,37,539,554
2055,377,584,207,17,193,208
2056,137,634,497,33,483,498
2057,303,326,23,5,9,24
2058,456,0,-456,35,530,545
2059,442,637,195,15,181,196
2060,623,928,305,21,291,306
2061,572,378,-194,53,792,807
2062,360,722,362,25,348,363
2063,536,714,178,13,164,179
2064,963,652,-311,45,675,690
2065,218,413,195,15,181,196
2066,87,12,-75,61,911,926
2067,998,973,-25,65,961,976
2068,429,233,-196,52,790,805
2069,18,622,604,40,590,605
2070,951,510,-441,39,545,560
2071,962,267,-695,21,291,306
2072,504,875,371,26,357,372
2073,63,446,383,28,369,384
2074,608,88,-520,31,466,481
2075,434,193,-241,51,745,760
2076,659,337,-322,45,664,679
2077,977,175,-802,15,184,199
2078,145,506,361,25,347,362
2079,333,139,-194,53,792,807
2080,752,177,-575,29,411,426
2081,120,701,581,39,567,582
2082,365,362,-3,65,983,998
2083,350,989,639,44,625,640
2084,358,258,-100,58,886,901
2085,506,804,298,21,284,299
2086,425,837,412,28,398,413
2087,430,344,-86,59,900,915
2088,733,467,-266,49,720,735
2089,855,387,-468,35,518,533
2090,302,934,632,41,618,633
2091,433,576,143,13,129,144
2092,298,115,-183,53,803,818
2093,681,266,-415,39,571,586
2094,842,57,-785,17,201,216
2095,736,776,40,4,26,41
2096,15,891,876,57,862,877
2097,456,637,181,14,167,182
2098,429,758,329,23,315,330
2099,56,118,62,7,48,63
2100,813,236,-577,30,409,424
2101,722,241,-481,36,505,520
2102,542,789,247,19,233,248
2103,917,128,-789,16,197,212
2104,997,826,-171,55,815,830
2105,543,800,257,18,243,258
2106,87,900,813,54,799,814
2107,278,422,144,10,130,145
2108,758,674,-84,59,902,917
2109,0,66,66,6,52,67
2110,810,243,-567,29,419,434
2111,62,905,843,56,829,844
2112,776,21,-755,18,231,246
2113,442,249,-193,54,793,808
2114,720,170,-550,30,436,451
2115,521,334,-187,54,799,814
2116,754,240,-514,33,472,487
2117,564,446,-118,57,868,883
2118,170,394,224,15,210,225
2119,287,455,168,12,154,169
2120,492,994,502,34,488,503
2121,518,13,-505,35,481,496
2122,653,24,-629,26,357,372
2123,71,355,284,20,270,285
2124,305,547,242,17,228,243
2125,559,206,-353,44,633,648
2126,347,408,61,7,47,62
2127,211,264,53,6,39,54
2128,634,900,266,19,252,267
2129,870,922,52,5,38,53
2130,142,166,24,3,10,25
2131,684,8,-676,22,310,325
2132,786,976,190,15,176,191
2133,756,870,114,9,100,115
2134,234,521,287,22,273,288
2135,315,188,-127,57,859,874
2136,137,794,657,43,643,658
2137,135,234,99,9,85,100
2138,893,502,-391,40,595,610
2139,579,597,18,3,4,19
2140,573,874,301,22,287,302
2141,662,653,-9,66,977,992
2142,212,485,273,19,259,274
2143,301,680,379,27,365,380
2144,814,891,77,8,63,78
2145,813,651,-162,55,824,839
2146,48,117,69,7,55,70
2147,209,414,205,16,191,206
2148,288,265,-23,63,963,978
2149,480,376,-104,57,882,897
2150,709,674,-35,63,951,966
2151,225,605,380,26,366,381
2152,292,970,678,45,664,679
2153,718,384,-334,44,652,667
2154,824,455,-369,43,617,632
2155,566,335,-231,50,755,770
2156,880,465,-415,39,571,586
2157,626,146,-480,34,506,521
2158,407,657,250,18,236,251
2159,409,21,-388,40,598,613
2160,309,972,663,45,649,664
2161,912,41,-871,10,115,130
2162,542,966,424,28,410,425
2163,684,929,245,18,231,246
2164,890,750,-140,56,846,861
2165,69,733,664,43,650,665
2166,86,612,526,36,512,527
2167,116,254,138,11,124,139
2168,166,618,452,30,438,453
2169,246,846,600,39,586,601
2170,105,744,639,44,625,640
2171,507,161,-346,44,640,655
2172,887,742,-145,57,841,856
2173,409,472,63,8,49,64
2174,270,124,-146,56,840,855
2175,998,753,-245,50,741,756
2176,86,949,863,58,849,864
2177,472,82,-390,40,596,611
2178,613,877,264,18,250,265
2179,412,938,526,36,512,527
2180,268,284,16,2,2,17
2181,326,360,34,4,20,35
2182,842,61,-781,17,205,220
2183,826,672,-154,56,832,847
2184,868,490,-378,42,608,623
2185,307,760,453,31,439,454
2186,154,310,156,12,142,157
2187,337,211,-126,57,860,875
2188,292,66,-226,51,760,775
2189,613,719,106,9,92,107
2190,81,702,621,42,607,622
2191,185,351,166,13,152,167
2192,66,38,-28,63,958,973
2193,931,674,-257,50,729,744
2194,228,188,-40,61,946,961
2195,570,635,65,6,51,66
2196,722,50,-672,22,314,329
2197,640,280,-360,41,626,641
2198,97,943,846,56,832,847
2199,516,149,-367,42,619,634
2200,349,48,-301,47,685,700
2201,137,895,758,50,744,759
2202,703,762,59,7,45,60
2203,600,628,28,4,14,29
2204,959,209,-750,18,236,251
2205,234,826,592,38,578,593
2206,348,744,396,27,382,397
2207,313,3,-310,45,676,691
2208,366,851,485,33,471,486
2209,187,32,-155,56,831,846
2210,919,91,-828,13,158,173
2211,98,110,12,3,6,13
2212,990,925,-65,62,921,936
2213,979,40,-939,7,47,62
2214,694,663,-31,63,955,970
2215,467,875,408,27,394,409
2216,425,611,186,14,172,187
2217,668,449,-219,52,767,782
2218,191,332,141,12,127,142
2219,122,71,-51,62,935,950
2220,562,931,369,25,355,370
2221,780,518,-262,48,724,739
2222,424,486,62,7,48,63
2223,972,777,-195,53,791,806
2224,34,533,499,34,485,500
2225,4,287,283,21,269,284
2226,521,32,-489,36,497,512
2227,481,119,-362,43,624,639
2228,743,994,251,19,237,252
2229,276,729,453,31,439,454
2230,821,390,-431,38,555,570
2231,111,388,277,20,263,278
2232,59,750,691,46,677,692
2233,998,121,-877,11,109,124
2234,227,870,643,43,629,644
2235,369,143,-226,51,760,775
2236,740,239,-501,34,485,500
2237,53,754,701,47,687,702
2238,59,655,596,39,582,597
2239,979,578,-401,41,585,600
2240,339,897,558,38,544,559
2241,154,994,840,54,826,841
2242,601,457,-144,55,842,857
2243,945,531,-414,39,572,587
2244,404,371,-33,64,953,968
2245,379,760,381,27,367,382
2246,433,848,415,30,401,416
2247,237,986,749,50,735,750
2248,876,753,-123,58,863,878
2249,18,211,193,14,179,194
2250,482,106,-376,40,610,625
2251,399,837,438,30,424,439
2252,595,752,157,13,143,158
2253,734,324,-410,40,576,591
2254,385,90,-295,46,691,706
2255,773,401,-372,41,614,629
2256,196,914,718,48,704,719
2257,686,755,69,7,55,70
2258,944,641,-303,46,683,698
2259,41,220,179,14,165,180
2260,699,114,-585,30,401,416
2261,550,103,-447,37,539,554
2262,158,154,-4,64,982,997
2263,297,371,74,7,60,75
2264,281,817,536,35,522,537
2265,698,10,-688,21,298,313
2266,425,572,147,12,133,148
2267,954,301,-653,25,333,348
2268,278,251,-27,64,959,974
2269,632,840,208,14,194,209
2270,529,502,-27,64,959,974
2271,416,724,308,21,294,309
2272,206,318,112,8,98,113
2273,687,569,-118,57,868,883
2274,479,829,350,25,336,351
2275,977,566,-411,40,575,590
2276,176,536,360,24,346,361
2277,925,615,-310,45,676,691
2278,106,669,563,38,549,564
2279,822,237,-585,30,401,416
2280,321,594,273,19,259,274
2281,398,571,173,14,159,174
2282,837,846,9,3,3,10
2283,73,603,530,35,516,531
2284,513,418,-95,59,891,906
2285,873,771,-102,58,884,899
2286,686,114,-572,29,414,429
2287,693,492,-201,54,785,800
2288,720,144,-576,28,410,425
2289,16,755,739,49,725,740
2290,559,776,217,16,203,218
2291,819,840,21,4,7,22
2292,516,932,416,27,402,417
2293,5,361,356,24,342,357
2294,984,14,-970,5,16,31
2295,916,627,-289,48,697,712
2296,169,612,443,31,429,444
2297,131,940,809,53,795,810
2298,567,422,-145,57,841,856
2299,233,587,354,24,340,355
2300,102,331,229,17,215,230
2301,506,406,-100,58,886,901
2302,701,178,-523,33,463,478
2303,113,34,-79,60,907,922
2304,668,3,-665,25,321,336
2305,295,980,685,46,671,686
2306,451,333,-118,57,868,883
2307,676,753,77,8,63,78
2308,798,792,-6,64,980,995
2309,688,397,-291,47,695,710
2310,601,358,-243,50,743,758
2311,55,445,390,27,376,391
2312,993,858,-135,56,851,866
2313,204,760,556,37,542,557
2314,678,973,295,22,281,296
2315,977,347,-630,25,356,371
2316,967,434,-533,32,453,468
2317,475,776,301,22,287,302
2318,733,174,-559,30,427,442
2319,39,619,580,38,566,581
2320,656,594,-62,61,924,939
2321,555,673,118,10,104,119
2322,390,888,498,33,484,499
2323,665,646,-19,64,967,982
2324,942,134,-808,13,178,193
2325,192,565,373,26,359,374
2326,88,644,556,37,542,557
2327,10,112,102,9,88,103
2328,838,995,157,13,143,158
2329,318,145,-173,55,813,828
2330,62,551,489,33,475,490
2331,733,475,-258,49,728,743
2332,983,215,-768,16,218,233
2333,300,8,-292,46,694,709
2334,738,171,-567,29,419,434
2335,689,801,112,8,98,113
2336,641,610,-31,63,955,970
2337,180,215,35,5,21,36
2338,866,794,-72,59,914,929
2339,675,744,69,7,55,70
2340,891,367,-524,32,462,477
2341,892,490,-402,40,584,599
2342,332,528,196,14,182,197
2343,103,58,-45,63,941,956
2344,239,543,304,20,290,305
2345,178,729,551,38,537,552
2346,144,880,736,47,722,737
2347,277,138,-139,57,847,862
2348,476,231,-245,50,741,756
2349,779,279,-500,33,486,501
2350,564,140,-424,37,562,577
2351,391,564,173,14,159,174
2352,111,12,-99,59,887,902
2353,770,784,14,4,8,15
2354,915,600,-315,46,671,686
2355,202,677,475,33,461,476
2356,830,650,-180,53,806,821
2357,602,414,-188,53,798,813
2358,844,306,-538,32,448,463
2359,271,740,469,32,455,470
2360,922,246,-676,22,310,325
2361,280,844,564,37,550,565
2362,150,139,-11,65,975,990
2363,99,307,208,14,194,209
2364,477,610,133,11,119,134
2365,101,448,347,25,333,348
2366,136,777,641,42,627,642
2367,638,192,-446,37,540,555
2368,622,361,-261,49,725,740
2369,893,867,-26,64,960,975
2370,99,137,38,5,24,39
2371,368,56,-312,44,674,689
2372,429,679,250,18,236,251
2373,905,248,-657,25,329,344
2374,652,841,189,15,175,190
2375,312,972,660,43,646,661
2376,712,839,127,12,113,128
2377,240,883,643,43,629,644
2378,177,946,769,50,755,770
2379,475,870,395,28,381,396
2380,9,400,391,28,377,392
2381,790,109,-681,24,305,320
2382,216,887,671,46,657,672
2383,785,156,-629,26,357,372
2384,410,857,447,32,433,448
2385,777,895,118,10,104,119
2386,796,972,176,12,162,177
2387,249,200,-49,63,937,952
2388,460,72,-388,40,598,613
2389,2,429,427,30,413,428
2390,518,608,90,8,76,91
2391,373,907,534,36,520,535
2392,797,889,92,8,78,93
2393,444,39,-405,40,581,596
2394,558,135,-423,38,563,578
2395,717,247,-470,35,516,531
2396,198,563,365,26,351,366
2397,652,977,325,23,311,326
2398,490,706,216,15,202,217
2399,138,151,13,4,7,14
2400,418,184,-234,51,752,767
2401,828,389,-439,37,547,562
2402,85,319,234,17,220,235
2403,393,798,405,28,391,406
2404,307,437,130,10,116,131
2405,820,11,-809,16,177,192
2406,69,432,363,26,349,364
2407,686,428,-258,49,728,743
2408,435,144,-291,47,695,710
2409,866,793,-73,62,913,928
2410,272,641,369,25,355,370
2411,570,175,-395,41,591,606
2412,61,84,23,5,9,24
2413,588,967,379,27,365,380
2414,828,358,-470,35,516,531
2415,379,682,303,23,289,304
2416,888,641,-247,49,739,754
2417,880,16,-864,10,122,137
2418,262,938,676,44,662,677
2419,490,145,-345,45,641,656
2420,800,488,-312,44,674,689
2421,142,154,12,3,6,13
2422,433,608,175,15,161,176
2423,808,710,-98,59,888,903
2424,593,392,-201,54,785,800
2425,58,541,483,33,469,484
2426,49,420,371,26,357,372
2427,69,641,572,38,558,573
2428,25,486,461,32,447,462
2429,157,393,236,17,222,237
2430,641,750,109,10,95,110
2431,915,587,-328,43,658,673
2432,907,108,-799,15,187,202
2433,356,388,32,3,18,33
2434,828,344,-484,34,502,517
2435,730,213,-517,33,469,484
2436,867,690,-177,55,809,824
2437,136,809,673,44,659,674
2438,429,486,57,6,43,58
2439,138,281,143,13,129,144
2440,504,650,146,11,132,147
2441,804,222,-582,28,404,419
2442,117,855,738,48,724,739
2443,863,500,-363,43,623,638
2444,282,947,665,44,651,666
2445,817,336,-481,36,505,520
2446,374,29,-345,45,641,656
2447,931,417,-514,33,472,487
2448,927,558,-369,43,617,632
2449,541,921,380,26,366,381
2450,255,723,468,31,454,469
2451,725,601,-124,57,862,877
2452,77,896,819,54,805,820
2453,309,609,300,21,286,301
2454,949,299,-650,25,336,351
2455,226,439,213,16,199,214
2456,325,743,418,28,404,419
2457,452,36,-416,38,570,585
2458,338,631,293,21,279,294
2459,525,51,-474,36,512,527
2460,901,208,-693,22,293,308
2461,361,676,315,23,301,316
2462,330,486,156,12,142,157
2463,188,86,-102,58,884,899
2464,313,81,-232,49,754,769
2465,183,997,814,54,800,815
2466,151,398,247,19,233,248
2467,190,83,-107,59,879,894
2468,100,745,645,43,631,646
2469,51,233,182,14,168,183
2470,829,812,-17,65,969,984
2471,233,884,651,44,637,652
2472,690,943,253,19,239,254
2473,653,715,62,7,48,63
2474,901,65,-836,12,150,165
2475,122,708,586,39,572,587
2476,99,964,865,56,851,866
2477,319,633,314,22,300,315
2478,55,1,-54,61,932,947
2479,257,194,-63,61,923,938
2480,642,283,-359,42,627,642
2481,939,360,-579,29,407,422
2482,407,669,262,19,248,263
2483,561,277,-284,47,702,717
2484,995,718,-277,48,709,724
2485,18,531,513,34,499,514
2486,665,993,328,22,314,329
2487,299,205,-94,59,892,907
2488,822,875,53,6,39,54
2489,487,804,317,23,303,318
2490,875,326,-549,31,437,452
2491,81,423,342,24,328,343
2492,853,523,-330,45,656,671
2493,243,602,359,26,345,360
2494,185,226,41,5,27,42
2495,233,573,340,23,326,341
2496,528,848,320,21,306,321
2497,765,160,-605,28,381,396
2498,928,922,-6,64,980,995
2499,815,433,-382,41,604,619
2500,617,47,-570,30,416,431
2501,756,561,-195,53,791,806
2502,545,125,-420,38,566,581
2503,355,575,220,16,206,221
2504,125,830,705,46,691,706
2505,175,728,553,37,539,554
2506,171,546,375,27,361,376
2507,988,699,-289,48,697,712
2508,991,387,-604,27,382,397
2509,400,542,142,12,128,143
2510,439,285,-154,56,832,847
2511,298,802,504,33,490,505
2512,865,194,-671,23,315,330
2513,57,33,-24,62,962,977
2514,389,770,381,27,367,382
2515,215,785,570,38,556,571
2516,196,225,29,5,15,30
2517,306,259,-47,62,939,954
2518,696,1,-695,21,291,306
2519,162,708,546,36,532,547
2520,73,93,20,3,6,21
2521,74,425,351,26,337,352
2522,288,426,138,11,124,139
2523,969,181,-788,15,198,213
2524,203,319,116,9,102,117
2525,82,419,337,23,323,338
2526,259,426,167,14,153,168
2527,262,23,-239,50,747,762
2528,824,373,-451,37,535,550
2529,228,983,755,50,741,756
2530,345,812,467,32,453,468
2531,41,820,779,52,765,780
2532,599,999,400,26,386,401
2533,458,75,-383,41,603,618
2534,59,962,903,60,889,904
2535,871,88,-783,16,203,218
2536,449,322,-127,57,859,874
2537,261,726,465,31,451,466
2538,873,763,-110,58,876,891
2539,865,754,-111,58,875,890
2540,310,808,498,33,484,499
2541,612,195,-417,40,569,584
2542,848,207,-641,26,345,360
2543,891,124,-767,17,219,234
2544,197,412,215,17,201,216
2545,90,638,548,36,534,549
2546,76,766,690,45,676,691
2547,933,310,-623,26,363,378
2548,590,547,-43,63,943,958
2549,843,924,81,7,67,82
2550,715,648,-67,61,919,934
2551,530,195,-335,44,651,666
2552,972,839,-133,57,853,868
2553,639,866,227,17,213,228
2554,75,230,155,13,141,156
2555,170,289,119,11,105,120
2556,980,453,-527,32,459,474
2557,366,251,-115,58,871,886
2558,723,904,181,14,167,182
2559,769,699,-70,60,916,931
2560,433,217,-216,50,770,785
2561,597,414,-183,53,803,818
2562,672,463,-209,53,777,792
2563,787,356,-431,38,555,570
2564,188,200,12,3,6,13
2565,831,807,-24,62,962,977
2566,589,549,-40,61,946,961
2567,622,720,98,8,84,99
2568,564,608,44,5,30,45
2569,167,484,317,23,303,318
2570,986,156,-830,13,156,171
2571,247,901,654,44,640,655
2572,765,374,-391,40,595,610
2573,748,674,-74,61,912,927
2574,826,156,-670,23,316,331
2575,107,471,364,25,350,365
2576,52,60,8,2,2,9
2577,4,20,16,2,2,17
2578,418,197,-221,52,765,780
2579,736,655,-81,61,905,920
2580,147,526,379,27,365,380
2581,438,454,16,2,2,17
2582,333,589,256,17,242,257
2583,471,780,309,22,295,310
2584,886,275,-611,27,375,390
2585,450,932,482,32,468,483
2586,795,382,-413,40,573,588
2587,900,724,-176,53,810,825
2588,874,306,-568,28,418,433
2589,370,248,-122,58,864,879
2590,397,449,52,5,38,53
2591,641,863,222,17,208,223
2592,456,153,-303,46,683,698
2593,98,948,850,55,836,851
2594,888,35,-853,12,133,148
2595,592,248,-344,42,642,657
2596,185,801,616,40,602,617
2597,856,409,-447,37,539,554
2598,991,380,-611,27,375,390
2599,278,581,303,23,289,304
2600,417,734,317,23,303,318
2601,68,262,194,14,180,195
2602,841,337,-504,32,482,497
2603,372,615,243,18,229,244
2604,944,463,-481,36,505,520
2605,208,281,73,7,59,74
2606,414,557,143,13,129,144
2607,950,84,-866,11,120,135
2608,707,245,-462,36,524,539
2609,993,794,-199,52,787,802
2610,805,821,16,2,2,17
2611,34,875,841,55,827,842
2612,234,348,114,9,100,115
2613,422,315,-107,59,879,894
2614,427,768,341,24,327,342
2615,230,714,484,32,470,485
2616,398,389,-9,66,977,992
2617,677,686,9,3,3,10
2618,41,53,12,3,6,13
2619,397,684,287,22,273,288
2620,965,678,-287,47,699,714
2621,566,646,80,6,66,81
2622,717,617,-100,58,886,901
2623,35,414,379,27,365,380
2624,481,114,-367,42,619,634
2625,810,70,-740,18,246,261
2626,856,11,-845,13,141,156
2627,594,620,26,4,12,27
2628,351,102,-249,51,737,752
2629,907,363,-544,30,442,457
2630,137,296,159,14,145,160
2631,786,181,-605,28,381,396
2632,302,267,-35,63,951,966
2633,637,583,-54,61,932,947
2634,825,574,-251,50,735,750
2635,855,374,-481,36,505,520
2636,271,79,-192,52,794,809
2637,848,227,-621,27,365,380
2638,266,288,22,4,8,23
2639,205,911,706,46,692,707
2640,6,264,258,18,244,259
2641,544,409,-135,56,851,866
2642,63,467,404,27,390,405
2643,700,809,109,10,95,110
2644,176,503,327,24,313,328
2645,703,97,-606,27,380,395
2646,175,712,537,36,523,538
2647,384,365,-19,64,967,982
2648,399,108,-291,47,695,710
2649,179,263,84,7,70,85
2650,288,930,642,42,628,643
2651,959,64,-895,9,91,106
2652,323,881,558,38,544,559
2653,657,851,194,14,180,195
2654,543,240,-303,46,683,698
2655,848,905,57,6,43,58
2656,940,730,-210,52,776,791
2657,105,538,433,29,419,434
2658,506,610,104,8,90,105
2659,422,921,499,34,485,500
2660,209,628,419,29,405,420
2661,589,88,-501,34,485,500
2662,867,102,-765,18,221,236
2663,942,799,-143,56,843,858
2664,659,368,-291,47,695,710
2665,809,167,-642,25,344,359
2666,754,853,99,9,85,100
2667,41,399,358,25,344,359
2668,142,842,700,46,686,701
2669,795,115,-680,21,306,321
2670,64,772,708,46,694,709
2671,422,483,61,7,47,62
2672,564,3,-561,31,425,440
2673,962,148,-814,14,172,187
2674,491,622,131,11,117,132
2675,362,993,631,43,617,632
2676,268,839,571,39,557,572
2677,226,786,560,36,546,561
2678,349,858,509,35,495,510
2679,951,418,-533,32,453,468
2680,399,185,-214,51,772,787
2681,858,925,67,7,53,68
2682,58,400,342,24,328,343
2683,43,666,623,43,609,624
2684,441,313,-128,56,858,873
2685,69,377,308,21,294,309
2686,428,250,-178,54,808,823
2687,526,162,-364,42,622,637
2688,792,994,202,15,188,203
2689,33,532,499,34,485,500
2690,105,331,226,16,212,227
2691,256,208,-48,61,938,953
2692,990,524,-466,36,520,535
2693,951,592,-359,42,627,642
2694,415,789,374,26,360,375
2695,795,689,-106,59,880,895
2696,10,927,917,60,903,918
2697,265,962,697,46,683,698
2698,560,743,183,15,169,184
2699,346,61,-285,48,701,716
2700,992,722,-270,48,716,731
2701,431,850,419,29,405,420
2702,10,787,777,51,763,778
2703,761,271,-490,35,496,511
2704,530,188,-342,43,644,659
2705,173,488,315,23,301,316
2706,120,269,149,12,135,150
2707,211,654,443,31,429,444
2708,24,47,23,5,9,24
2709,363,16,-347,44,639,654
2710,617,220,-397,41,589,604
2711,847,199,-648,23,338,353
2712,830,960,130,10,116,131
2713,55,981,926,61,912,927
2714,390,171,-219,52,767,782
2715,590,438,-152,54,834,849
2716,638,629,-9,66,977,992
2717,274,191,-83,60,903,918
2718,26,427,401,27,387,402
2719,156,932,776,50,762,777
2720,425,948,523,36,509,524
2721,496,321,-175,54,811,826
2722,0,580,580,38,566,581
2723,815,345,-470,35,516,531
2724,705,336,-369,43,617,632
2725,626,845,219,17,205,220
2726,379,822,443,31,429,444
2727,259,410,151,13,137,152
2728,191,388,197,15,183,198
2729,687,247,-440,36,546,561
2730,170,80,-90,60,896,911
2731,455,192,-263,48,723,738
2732,835,217,-618,27,368,383
2733,160,845,685,46,671,686
2734,219,292,73,7,59,74
2735,598,52,-546,31,440,455
2736,915,906,-9,66,977,992
2737,814,698,-116,57,870,885
2738,275,569,294,21,280,295
2739,273,820,547,37,533,548
2740,884,370,-514,33,472,487
2741,220,641,421,29,407,422
2742,662,14,-648,23,338,353
2743,978,479,-499,34,487,502
2744,710,204,-506,34,480,495
2745,31,653,622,42,608,623
2746,388,481,93,9,79,94
2747,867,870,3,3,3,4
2748,971,497,-474,36,512,527
2749,236,596,360,24,346,361
2750,885,935,50,5,36,51
2751,938,811,-127,57,859,874
2752,552,458,-94,59,892,907
2753,404,551,147,12,133,148
2754,755,138,-617,28,369,384
2755,458,728,270,20,256,271
2756,807,244,-563,30,423,438
2757,932,366,-566,29,420,435
2758,852,541,-311,45,675,690
2759,842,562,-280,46,706,721
2760,230,128,-102,58,884,899
2761,211,212,1,2,2,2
2762,124,189,65,6,51,66
2763,711,427,-284,47,702,717
2764,865,244,-621,27,365,380
2765,377,476,99,9,85,100
2766,885,556,-329,46,657,672
2767,892,194,-698,22,288,303
2768,191,591,400,26,386,401
2769,550,520,-30,63,956,971
2770,579,599,20,3,6,21
2771,352,917,565,38,551,566
2772,885,818,-67,61,919,934
2773,287,89,-198,52,788,803
2774,507,758,251,19,237,252
2775,179,950,771,51,757,772
2776,823,195,-628,25,358,373
2777,904,190,-714,21,272,287
2778,588,261,-327,44,659,674
2779,215,92,-123,58,863,878
2780,167,822,655,45,641,656
2781,960,674,-286,47,700,715
2782,81,751,670,45,656,671
2783,452,77,-375,41,611,626
2784,860,913,53,6,39,54
2785,283,985,702,47,688,703
2786,63,634,571,39,557,572
2787,840,924,84,7,70,85
2788,417,540,123,11,109,124
2789,142,971,829,55,815,830
2790,668,802,134,11,120,135
2791,429,642,213,16,199,214
2792,942,676,-266,49,720,735
2793,155,718,563,38,549,564
2794,306,626,320,21,306,321
2795,936,591,-345,45,641,656
2796,471,532,61,7,47,62
2797,725,867,142,12,128,143
2798,905,703,-202,53,784,799
2799,691,44,-647,24,339,354
2800,556,116,-440,36,546,561
2801,975,319,-656,23,330,345
2802,520,744,224,15,210,225
2803,302,493,191,16,177,192
2804,69,65,-4,64,982,997
2805,612,19,-593,29,393,408
2806,879,379,-500,33,486,501
2807,178,566,388,26,374,389
2808,592,643,51,6,37,52
2809,776,113,-663,23,323,338
2810,51,190,139,12,125,140
2811,218,453,235,18,221,236
2812,220,510,290,20,276,291
2813,827,257,-570,30,416,431
2814,631,664,33,4,19,34
2815,534,516,-18,64,968,983
2816,660,177,-483,35,503,518
2817,54,100,46,6,32,47
2818,301,287,-14,64,972,987
2819,158,410,252,18,238,253
2820,915,44,-871,10,115,130
2821,785,212,-573,30,413,428
2822,111,853,742,49,728,743
2823,127,381,254,19,240,255
2824,313,224,-89,61,897,912
2825,712,982,270,20,256,271
2826,392,796,404,27,390,405
2827,701,976,275,20,261,276
2828,935,558,-377,43,609,624
2829,636,849,213,16,199,214
2830,424,684,260,18,246,261
2831,146,117,-29,64,957,972
2832,897,304,-593,29,393,408
2833,33,985,952,61,938,953
2834,589,758,169,13,155,170
2835,798,897,99,9,85,100
2836,122,17,-105,60,881,896
2837,589,91,-498,34,488,503
2838,843,125,-718,20,268,283
2839,227,852,625,41,611,626
2840,28,152,124,10,110,125
2841,315,224,-91,60,895,910
2842,302,390,88,7,74,89
2843,315,763,448,29,434,449
2844,759,441,-318,45,668,683
2845,611,843,232,16,218,233
2846,351,591,240,16,226,241
2847,40,55,15,5,9,16
2848,81,580,499,34,485,500
2849,751,732,-19,64,967,982
2850,805,277,-528,31,458,473
2851,866,324,-542,31,444,459
2852,400,113,-287,47,699,714
2853,286,66,-220,51,766,781
2854,945,644,-301,47,685,700
2855,73,752,679,46,665,680
2856,340,999,659,44,645,660
2857,755,806,51,6,37,52
2858,53,685,632,41,618,633
2859,768,119,-649,26,337,352
2860,94,628,534,36,520,535
2861,553,943,390,27,376,391
2862,548,663,115,10,101,116
2863,618,758,140,11,126,141
2864,831,972,141,12,127,142
2865,647,463,-184,52,802,817
2866,108,700,592,38,578,593
2867,140,258,118,10,104,119
2868,662,309,-353,44,633,648
2869,323,959,636,42,622,637
2870,248,972,724,47,710,725
2871,14,893,879,59,865,880
2872,0,377,377,26,363,378
2873,99,776,677,45,663,678
2874,468,882,414,29,400,415
2875,224,650,426,29,412,427
2876,789,386,-403,40,583,598
2877,525,615,90,8,76,91
2878,249,906,657,43,643,658
2879,977,823,-154,56,832,847
2880,742,348,-394,41,592,607
2881,645,12,-633,27,353,368
2882,753,996,243,18,229,244
2883,433,45,-388,40,598,613
2884,906,61,-845,13,141,156
2885,366,578,212,15,198,213
2886,350,111,-239,50,747,762
2887,736,18,-718,20,268,283
2888,271,415,144,10,130,145
2889,84,546,462,32,448,463
2890,898,935,37,5,23,38
2891,571,464,-107,59,879,894
2892,858,685,-173,55,813,828
2893,94,24,-70,60,916,931
2894,949,282,-667,24,319,334
2895,992,322,-670,23,316,331
2896,330,764,434,29,420,435
2897,493,949,456,30,442,457
2898,1,429,428,29,414,429
2899,286,188,-98,59,888,903
2900,202,66,-136,55,850,865
2901,13,862,849,55,835,850
2902,411,994,583,40,569,584
2903,205,420,215,17,201,216
2904,634,963,329,23,315,330
2905,527,920,393,27,379,394
2906,34,121,87,9,73,88
2907,498,101,-397,41,589,604
2908,680,330,-350,43,636,651
2909,500,84,-416,38,570,585
2910,981,61,-920,6,66,81
2911,90,785,695,47,681,696
2912,163,721,558,38,544,559
2913,276,637,361,25,347,362
2914,207,488,281,20,267,282
2915,355,569,214,16,200,215
2916,660,369,-291,47,695,710
2917,306,106,-200,51,786,801
2918,487,19,-468,35,518,533
2919,650,387,-263,48,723,738
2920,155,744,589,40,575,590
2921,861,334,-527,32,459,474
2922,331,815,484,32,470,485
2923,316,732,416,27,402,417
2924,977,995,18,3,4,19
2925,570,137,-433,39,553,568
2926,293,661,368,24,354,369
2927,296,636,340,23,326,341
2928,834,238,-596,27,390,405
2929,669,15,-654,24,332,347
2930,497,303,-194,53,792,807
2931,17,924,907,60,893,908
2932,492,867,375,27,361,376
2933,782,930,148,11,134,149
2934,925,789,-136,55,850,865
2935,476,911,435,30,421,436
2936,706,204,-502,33,484,499
2937,9,560,551,38,537,552
2938,851,331,-520,31,466,481
2939,492,268,-224,50,762,777
2940,430,789,359,26,345,360
2941,302,503,201,15,187,202
2942,43,538,495,35,481,496
2943,461,386,-75,61,911,926
2944,74,243,169,13,155,170
2945,978,378,-600,26,386,401
2946,74,36,-38,62,948,963
2947,338,463,125,11,111,126
2948,599,259,-340,43,646,661
2949,764,449,-315,46,671,686
2950,934,862,-72,59,914,929
2951,280,569,289,20,275,290
2952,412,257,-155,56,831,846
2953,342,331,-11,65,975,990
2954,567,141,-426,39,560,575
2955,615,68,-547,31,439,454
2956,297,822,525,36,511,526
2957,119,201,82,7,68,83
2958,553,702,149,12,135,150
2959,523,632,109,10,95,110
2960,666,622,-44,62,942,957
2961,747,958,211,16,197,212
2962,280,183,-97,60,889,904
2963,245,29,-216,50,770,785
2964,850,6,-844,12,142,157
2965,159,335,176,12,162,177
2966,488,931,443,31,429,444
2967,931,331,-600,26,386,401
2968,485,133,-352,42,634,649
2969,443,948,505,34,491,506
2970,566,699,133,11,119,134
2971,975,928,-47,62,939,954
2972,25,458,433,29,419,434
2973,255,763,508,34,494,509
2974,735,455,-280,46,706,721
2975,358,718,360,24,346,361
2976,542,689,147,12,133,148
2977,438,652,214,16,200,215
2978,755,100,-655,24,331,346
2979,349,173,-176,53,810,825
2980,784,141,-643,25,343,358
2981,751,333,-418,39,568,583
2982,600,830,230,17,216,231
2983,817,37,-780,16,206,221
2984,8,748,740,48,726,741
2985,805,869,64,5,50,65
2986,110,112,2,2,2,3
2987,440,282,-158,55,828,843
2988,655,614,-41,64,945,960
2989,911,713,-198,52,788,803
2990,132,291,159,14,145,160
2991,663,744,81,7,67,82
2992,532,71,-461,37,525,540
2993,612,275,-337,45,649,664
2994,703,704,1,2,2,2
2995,845,910,65,6,51,66
2996,120,10,-110,58,876,891
2997,964,340,-624,25,362,377
2998,961,78,-883,10,103,118
2999,950,40,-910,8,76,91
3000,545,69,-476,35,510,525
3001,442,202,-240,49,746,761
3002,325,952,627,42,613,628
3003,182,100,-82,60,904,919
3004,589,965,376,25,362,377
3005,126,652,526,36,512,527
3006,264,672,408,27,394,409
3007,635,908,273,19,259,274
3008,226,879,653,44,639,654
3009,337,801,464,30,450,465
3010,145,627,482,32,468,483
3011,675,191,-484,34,502,517
3012,589,457,-132,56,854,869
3013,573,587,14,4,8,15
3014,280,808,528,34,514,529
3015,225,47,-178,54,808,823
3016,213,505,292,20,278,293
3017,366,814,448,29,434,449
3018,14,207,193,14,179,194
3019,816,128,-688,21,298,313
3020,838,169,-669,24,317,332
3021,708,321,-387,41,599,614
3022,946,699,-247,49,739,754
3023,716,306,-410,40,576,591
3024,593,955,362,25,348,363
3025,897,933,36,4,22,37
3026,351,114,-237,51,749,764
3027,268,525,257,18,243,258
3028,769,527,-242,50,744,759
3029,693,356,-337,45,649,664
3030,483,317,-166,54,820,835
3031,469,167,-302,46,684,699
3032,196,938,742,49,728,743
3033,877,965,88,7,74,89
3034,656,558,-98,59,888,903
3035,421,553,132,10,118,133
3036,967,419,-548,30,438,453
3037,940,657,-283,48,703,718
3038,964,273,-691,22,295,310
3039,831,114,-717,21,269,284
3040,368,648,280,19,266,281
3041,478,168,-310,45,676,691
3042,599,498,-101,59,885,900
3043,294,908,614,41,600,615
3044,565,320,-245,50,741,756
3045,341,893,552,36,538,553
3046,340,543,203,16,189,204
3047,855,367,-488,33,498,513
3048,861,859,-2,65,984,999
3049,510,846,336,22,322,337
3050,733,484,-249,51,737,752
3051,676,507,-169,56,817,832
3052,999,369,-630,25,356,371
3053,955,946,-9,66,977,992
3054,411,543,132,10,118,133
3055,82,99,17,3,3,18
3056,854,683,-171,55,815,830
3057,387,777,390,27,376,391
3058,484,990,506,34,492,507
3059,625,621,-4,64,982,997
3060,407,990,583,40,569,584
3061,528,891,363,26,349,364
3062,418,553,135,12,121,136
3063,211,269,58,6,44,59
3064,799,736,-63,61,923,938
3065,98,650,552,36,538,553
3066,975,569,-406,39,580,595
3067,862,360,-502,33,484,499
3068,389,102,-287,47,699,714
3069,683,381,-302,46,684,699
3070,22,187,165,13,151,166
3071,338,273,-65,62,921,936
3072,768,369,-399,40,587,602
3073,412,780,368,24,354,369
3074,959,724,-235,51,751,766
3075,261,302,41,5,27,42
3076,976,773,-203,53,783,798
3077,786,291,-495,34,491,506
3078,249,671,422,29,408,423
3079,163,149,-14,64,972,987
3080,670,602,-68,60,918,933
3081,822,671,-151,55,835,850
3082,527,182,-345,45,641,656
3083,476,611,135,12,121,136
3084,692,420,-272,47,714,729
3085,747,456,-291,47,695,710
3086,957,545,-412,39,574,589
3087,33,800,767,52,753,768
3088,854,40,-814,14,172,187
3089,739,435,-304,45,682,697
3090,535,600,65,6,51,66
3091,749,864,115,10,101,116
3092,534,495,-39,62,947,962
3093,344,176,-168,53,818,833
3094,452,282,-170,55,816,831
3095,123,572,449,30,435,450
3096,832,433,-399,40,587,602
3097,509,618,109,10,95,110
3098,490,344,-146,56,840,855
3099,749,985,236,17,222,237
3100,697,251,-446,37,540,555
3101,751,388,-363,43,623,638
3102,730,328,-402,40,584,599
3103,440,0,-440,36,546,561
3104,898,76,-822,13,164,179
3105,101,548,447,32,433,448
3106,460,749,289,20,275,290
3107,390,894,504,33,490,505
3108,56,255,199,16,185,200
3109,814,906,92,8,78,93
3110,796,614,-182,53,804,819
3111,94,989,895,60,881,896
3112,335,525,190,15,176,191
3113,681,700,19,4,5,20
3114,98,136,38,5,24,39
3115,75,110,35,5,21,36
3116,15,52,37,5,23,38
3117,639,28,-611,27,375,390
3118,647,569,-78,60,908,923
3119,495,719,224,15,210,225
3120,897,206,-691,22,295,310
3121,406,770,364,25,350,365
3122,627,695,68,6,54,69
3123,79,18,-61,62,925,940
3124,260,152,-108,58,878,893
3125,641,705,64,5,50,65
3126,715,21,-694,21,292,307
3127,451,784,333,24,319,334
3128,37,220,183,15,169,184
3129,841,136,-705,22,281,296
3130,353,664,311,23,297,312
3131,873,684,-189,54,797,812
3132,24,572,548,36,534,549
3133,11,941,930,60,916,931
3134,876,715,-161,56,825,840
3135,679,966,287,22,273,288
3136,933,4,-929,8,57,72
3137,412,632,220,16,206,221
3138,166,313,147,12,133,148
3139,656,445,-211,52,775,790
3140,449,44,-405,40,581,596
3141,499,355,-144,55,842,857
3142,910,183,-727,19,259,274
3143,862,468,-394,41,592,607
3144,978,775,-203,53,783,798
3145,851,709,-142,56,844,859
3146,650,829,179,14,165,180
3147,455,309,-146,56,840,855
3148,316,906,590,40,576,591
3149,836,154,-682,23,304,319
3150,935,617,-318,45,668,683
3151,213,456,243,18,229,244
3152,4,420,416,27,402,417
3153,318,916,598,40,584,599
3154,404,198,-206,52,780,795
3155,214,816,602,40,588,603
3156,913,592,-321,46,665,680
3157,675,950,275,20,261,276
3158,982,757,-225,52,761,776
3159,690,902,212,15,198,213
3160,337,851,514,34,500,515
3161,403,148,-255,49,731,746
3162,358,971,613,41,599,614
3163,273,258,-15,64,971,986
3164,712,198,-514,33,472,487
3165,446,176,-270,48,716,731
3166,894,950,56,5,42,57
3167,640,451,-189,54,797,812
3168,401,353,-48,61,938,953
3169,958,491,-467,36,519,534
3170,384,529,145,11,131,146
3171,362,705,343,25,329,344
3172,116,956,840,54,826,841
3173,705,422,-283,48,703,718
3174,758,327,-431,38,555,570
3175,673,527,-146,56,840,855
3176,429,453,24,3,10,25
3177,453,273,-180,53,806,821
3178,149,382,233,17,219,234
3179,126,348,222,17,208,223
3180,118,562,444,30,430,445
3181,92,529,437,30,423,438
3182,128,339,211,16,197,212
3183,251,432,181,14,167,182
3184,284,515,231,18,217,232
3185,13,866,853,56,839,854
3186,454,0,-454,36,532,547
3187,191,657,466,31,452,467
3188,176,267,91,9,77,92
3189,716,791,75,8,61,76
3190,309,166,-143,56,843,858
3191,679,589,-90,60,896,911
3192,554,313,-241,51,745,760
3193,135,17,-118,57,868,883
3194,257,945,688,44,674,689
3195,500,60,-440,36,546,561
3196,560,73,-487,34,499,514
3197,462,82,-380,41,606,621
3198,792,356,-436,37,550,565
3199,277,771,494,34,480,495
3200,447,382,-65,62,921,936
3201,42,699,657,43,643,658
3202,998,748,-250,50,736,751
3203,361,790,429,30,415,430
3204,947,225,-722,20,264,279
3205,807,969,162,12,148,163
3206,704,396,-308,45,678,693
3207,123,794,671,46,657,672
3208,566,350,-216,50,770,785
3209,341,415,74,7,60,75
3210,183,544,361,25,347,362
3211,198,697,499,34,485,500
3212,721,394,-327,44,659,674
3213,787,153,-634,26,352,367
3214,426,644,218,16,204,219
3215,384,204,-180,53,806,821
3216,580,125,-455,36,531,546
3217,418,968,550,37,536,551
3218,735,193,-542,31,444,459
3219,425,215,-210,52,776,791
3220,426,688,262,19,248,263
3221,481,516,35,5,21,36
3222,979,714,-265,50,721,736
3223,345,620,275,20,261,276
3224,127,826,699,47,685,700
3225,413,302,-111,58,875,890
3226,985,814,-171,55,815,830
3227,147,736,589,40,575,590
3228,284,544,260,18,246,261
3229,646,672,26,4,12,27
3230,539,991,452,30,438,453
3231,76,233,157,13,143,158
3232,992,73,-919,7,67,82
3233,431,876,445,31,431,446
3234,443,965,522,35,508,523
3235,756,0,-756,17,230,245
3236,489,224,-265,50,721,736
3237,596,564,-32,62,954,969
3238,689,316,-373,42,613,628
3239,121,106,-15,64,971,986
3240,413,352,-61,62,925,940
3241,895,119,-776,15,210,225
3242,825,401,-424,37,562,577
3243,979,228,-751,18,235,250
3244,589,440,-149,56,837,852
3245,888,64,-824,12,162,177
3246,207,98,-109,59,877,892
3247,282,327,45,6,31,46
3248,678,549,-129,58,857,872
3249,339,670,331,24,317,332
3250,475,96,-379,42,607,622
3251,80,466,386,26,372,387
3252,261,539,278,20,264,279
3253,404,808,404,27,390,405
3254,110,863,753,49,739,754
3255,213,906,693,46,679,694
3256,561,315,-246,49,740,755
3257,17,335,318,23,304,319
3258,969,831,-138,57,848,863
3259,212,566,354,24,340,355
3260,186,336,150,12,136,151
3261,449,401,-48,61,938,953
3262,24,39,15,5,9,16
3263,742,705,-37,63,949,964
3264,360,545,185,14,171,186
3265,615,263,-352,42,634,649
3266,839,18,-821,14,165,180
3267,45,29,-16,63,970,985
3268,734,838,104,8,90,105
3269,213,32,-181,54,805,820
3270,517,512,-5,65,981,996
3271,373,437,64,5,50,65
3272,473,341,-132,56,854,869
3273,196,982,786,51,772,787
3274,638,95,-543,31,443,458
3275,661,530,-131,57,855,870
3276,797,440,-357,43,629,644
3277,581,614,33,4,19,34
3278,687,601,-86,59,900,915
3279,393,236,-157,56,829,844
3280,311,930,619,42,605,620
3281,451,701,250,18,236,251
3282,154,666,512,33,498,513
3283,873,388,-485,35,501,516
3284,896,647,-249,51,737,752
3285,194,763,569,38,555,570
3286,239,352,113,9,99,114
3287,243,688,445,31,431,446
3288,235,238,3,3,3,4
3289,469,211,-258,49,728,743
3290,202,445,243,18,229,244
3291,608,303,-305,47,681,696
3292,918,863,-55,61,931,946
3293,707,269,-438,37,548,563
3294,38,159,121,10,107,122
3295,269,528,259,19,245,260
3296,224,574,350,25,336,351
3297,404,435,31,6,17,32
3298,514,500,-14,64,972,987
3299,54,660,606,41,592,607
3300,21,108,87,9,73,88
3301,21,7,-14,64,972,987
3302,504,46,-458,37,528,543
3303,206,810,604,40,590,605
3304,148,91,-57,63,929,944
3305,264,468,204,15,190,205
3306,556,286,-270,48,716,731
3307,308,912,604,40,590,605
3308,371,382,11,4,5,12
3309,238,945,707,47,693,708
3310,277,113,-164,54,822,837
3311,684,72,-612,26,374,389
3312,404,766,362,25,348,363
3313,42,551,509,35,495,510
3314,12,302,290,20,276,291
3315,442,137,-305,47,681,696
3316,793,826,33,4,19,34
3317,626,95,-531,32,455,470
3318,751,15,-736,18,250,265
3319,790,933,143,13,129,144
3320,907,120,-787,16,199,214
3321,16,460,444,30,430,445
3322,809,59,-750,18,236,251
3323,312,595,283,21,269,284
3324,436,697,261,19,247,262
3325,663,40,-623,26,363,378
3326,303,557,254,19,240,255
3327,659,396,-263,48,723,738
3328,468,640,172,13,158,173
3329,913,344,-569,31,417,432
3330,420,304,-116,57,870,885
3331,557,687,130,10,116,131
3332,954,294,-660,23,326,341
3333,49,262,213,16,199,214
3334,124,905,781,52,767,782
3335,222,40,-182,53,804,819
3336,308,65,-243,50,743,758
3337,729,52,-677,23,309,324
3338,257,411,154,12,140,155
3339,772,236,-536,30,450,465
3340,52,375,323,23,309,324
3341,401,460,59,7,45,60
3342,639,946,307,22,293,308
3343,721,25,-696,20,290,305
3344,925,677,-248,48,738,753
3345,626,43,-583,28,403,418
3346,234,900,666,44,652,667
3347,71,748,677,45,663,678
3348,188,784,596,39,582,597
3349,414,763,349,25,335,350
3350,380,367,-13,65,973,988
3351,574,544,-30,63,956,971
3352,249,648,399,29,385,400
3353,12,342,330,23,316,331
3354,487,601,114,9,100,115
3355,582,259,-323,45,663,678
3356,49,479,430,30,416,431
3357,958,928,-30,63,956,971
3358,36,254,218,16,204,219
3359,65,593,528,34,514,529
3360,66,339,273,19,259,274
3361,521,792,271,21,257,272
3362,994,451,-543,31,443,458
3363,296,105,-191,53,795,810
3364,842,373,-469,36,517,532
3365,946,721,-225,52,761,776
3366,694,497,-197,53,789,804
3367,544,596,52,5,38,53
3368,128,144,16,2,2,17
3369,935,805,-130,57,856,871
3370,853,963,110,10,96,111
3371,983,924,-59,62,927,942
3372,990,650,-340,43,646,661
3373,422,727,305,21,291,306
3374,703,814,111,11,97,112
3375,274,153,-121,59,865,880
3376,445,912,467,32,453,468
3377,488,626,138,11,124,139
3378,777,328,-449,38,537,552
3379,91,774,683,46,669,684
3380,236,985,749,50,735,750
3381,523,766,243,18,229,244
3382,817,978,161,12,147,162
3383,342,46,-296,45,690,705
3384,391,590,199,16,185,200
3385,368,555,187,15,173,188
3386,638,946,308,21,294,309
3387,692,903,211,16,197,212
3388,648,673,25,4,11,26
3389,905,540,-365,43,621,636
3390,32,353,321,22,307,322
3391,83,815,732,48,718,733
3392,425,301,-124,57,862,877
3393,134,782,648,42,634,649
3394,687,538,-149,56,837,852
3395,445,330,-115,58,871,886
3396,877,892,15,5,9,16
3397,384,741,357,25,343,358
3398,470,86,-384,40,602,617
3399,940,926,-14,64,972,987
3400,495,673,178,13,164,179
3401,287,319,32,3,18,33
3402,800,911,111,11,97,112
3403,210,806,596,39,582,597
3404,138,968,830,55,816,831
3405,927,651,-276,47,710,725
3406,315,46,-269,49,717,732
3407,722,969,247,19,233,248
3408,672,745,73,7,59,74
3409,419,555,136,10,122,137
3410,893,903,10,3,4,11
3411,291,395,104,8,90,105
3412,288,661,373,26,359,374
3413,212,196,-16,63,970,985
3414,673,429,-244,49,742,757
3415,95,147,52,5,38,53
3416,610,812,202,15,188,203
3417,84,383,299,22,285,300
3418,519,987,468,31,454,469
3419,610,558,-52,61,934,949
3420,338,689,351,26,337,352
3421,598,186,-412,39,574,589
3422,976,533,-443,38,543,558
3423,215,348,133,11,119,134
3424,921,420,-501,34,485,500
3425,732,769,37,5,23,38
3426,671,622,-49,63,937,952
3427,776,21,-755,18,231,246
3428,723,335,-388,40,598,613
3429,893,818,-75,61,911,926
3430,37,586,549,37,535,550
3431,456,100,-356,42,630,645
3432,532,628,96,7,82,97
3433,819,957,138,11,124,139
3434,103,756,653,44,639,654
3435,768,12,-756,17,230,245
3436,693,596,-97,60,889,904
3437,77,128,51,6,37,52
3438,978,93,-885,10,101,116
3439,938,307,-631,25,355,370
3440,467,463,-4,64,982,997
3441,212,171,-41,64,945,960
3442,473,858,385,26,371,386
3443,90,434,344,23,330,345
3444,939,616,-323,45,663,678
3445,610,501,-109,59,877,892
3446,853,841,-12,64,974,989
3447,590,507,-83,60,903,918
3448,742,409,-333,45,653,668
3449,0,106,106,9,92,107
3450,998,806,-192,52,794,809
3451,980,782,-198,52,788,803
3452,192,371,179,14,165,180
3453,772,768,-4,64,982,997
3454,655,533,-122,58,864,879
3455,173,442,269,20,255,270
3456,404,455,51,6,37,52
3457,342,704,362,25,348,363
3458,232,791,559,39,545,560
3459,717,622,-95,59,891,906
3460,635,222,-413,40,573,588
3461,848,989,141,12,127,142
3462,633,805,172,13,158,173
3463,967,994,27,5,13,28
3464,44,77,33,4,19,34
3465,50,166,116,9,102,117
3466,171,227,56,5,42,57
3467,423,448,25,4,11,26
3468,908,965,57,6,43,58
3469,991,52,-939,7,47,62
3470,171,592,421,29,407,422
3471,174,992,818,53,804,819
3472,127,66,-61,62,925,940
3473,827,965,138,11,124,139
3474,445,687,242,17,228,243
3475,933,551,-382,41,604,619
3476,738,472,-266,49,720,735
3477,222,692,470,32,456,471
3478,919,759,-160,54,826,841
3479,846,388,-458,37,528,543
3480,688,632,-56,60,930,945
3481,636,635,-1,66,985,1000
3482,841,255,-586,29,400,415
3483,686,419,-267,49,719,734
3484,383,320,-63,61,923,938
3485,849,542,-307,46,679,694
3486,244,722,478,33,464,479
3487,435,963,528,34,514,529
3488,677,505,-172,54,814,829
3489,60,127,67,7,53,68
3490,434,502,68,6,54,69
3491,109,986,877,58,863,878
3492,561,358,-203,53,783,798
3493,49,132,83,8,69,84
3494,886,415,-471,35,515,530
3495,487,913,426,29,412,427
3496,47,841,794,52,780,795
3497,80,393,313,22,299,314
3498,726,983,257,18,243,258
3499,445,90,-355,43,631,646
3500,224,924,700,46,686,701
3501,545,997,452,30,438,453
3502,141,466,325,23,311,326
3503,355,569,214,16,200,215
3504,926,468,-458,37,528,543
3505,112,352,240,16,226,241
3506,26,426,400,26,386,401
3507,986,309,-677,23,309,324
3508,677,114,-563,30,423,438
3509,347,908,561,37,547,562
3510,663,648,-15,64,971,986
3511,411,947,536,35,522,537
3512,139,525,386,26,372,387
3513,666,123,-543,31,443,458
3514,952,189,-763,18,223,238
3515,627,424,-203,53,783,798
3516,158,226,68,6,54,69
3517,486,438,-48,61,938,953
3518,405,14,-391,40,595,610
3519,697,570,-127,57,859,874
3520,84,296,212,15,198,213
3521,578,388,-190,53,796,811
3522,492,755,263,20,249,264
3523,269,581,312,21,298,313
3524,528,723,195,15,181,196
3525,490,930,440,29,426,441
3526,408,653,245,18,231,246
3527,669,64,-605,28,381,396
3528,160,489,329,23,315,330
3529,955,550,-405,40,581,596
3530,921,508,-413,40,573,588
3531,357,530,173,14,159,174
3532,817,396,-421,39,565,580
3533,20,571,551,38,537,552
3534,529,988,459,32,445,460
3535,418,708,290,20,276,291
3536,615,544,-71,60,915,930
3537,735,340,-395,41,591,606
3538,159,352,193,14,179,194
3539,31,889,858,56,844,859
3540,284,957,673,44,659,674
3541,317,796,479,34,465,480
3542,140,111,-29,64,957,972
3543,430,80,-350,43,636,651
3544,955,983,28,4,14,29
3545,736,148,-588,28,398,413
3546,531,880,349,25,335,350
3547,411,157,-254,49,732,747
3548,596,801,205,16,191,206
3549,728,725,-3,65,983,998
3550,178,586,408,27,394,409
3551,951,463,-488,33,498,513
3552,3,84,81,7,67,82
3553,58,519,461,32,447,462
3554,685,655,-30,63,956,971
3555,909,949,40,4,26,41
3556,984,51,-933,7,53,68
3557,388,313,-75,61,911,926
3558,741,204,-537,33,449,464
3559,21,562,541,37,527,542
3560,569,225,-344,42,642,657
3561,931,309,-622,26,364,379
3562,476,846,370,25,356,371
3563,827,99,-728,18,258,273
3564,731,380,-351,43,635,650
3565,479,484,5,3,3,6
3566,314,886,572,38,558,573
3567,969,942,-27,64,959,974
3568,938,276,-662,23,324,339
3569,10,318,308,21,294,309
3570,478,459,-19,64,967,982
3571,876,500,-376,40,610,625
3572,227,217,-10,65,976,991
3573,901,79,-822,13,164,179
3574,657,248,-409,41,577,592
3575,998,308,-690,22,296,311
3576,14,596,582,39,568,583
3577,810,759,-51,62,935,950
3578,496,37,-459,37,527,542
3579,911,70,-841,14,145,160
3580,841,676,-165,55,821,836
3581,701,547,-154,56,832,847
3582,476,129,-347,44,639,654
3583,434,342,-92,59,894,909
3584,480,351,-129,58,857,872
3585,774,537,-237,51,749,764
3586,337,5,-332,44,654,669
3587,292,969,677,45,663,678
3588,425,509,84,7,70,85
3589,39,795,756,49,742,757
3590,745,975,230,17,216,231
3591,191,435,244,17,230,245
3592,9,806,797,53,783,798
3593,381,643,262,19,248,263
3594,472,361,-111,58,875,890
3595,480,498,18,3,4,19
3596,345,74,-271,48,715,730
3597,436,615,179,14,165,180
3598,8,167,159,14,145,160
3599,495,497,2,2,2,3
3600,179,479,300,21,286,301
3601,339,459,120,9,106,121
3602,67,853,786,51,772,787
3603,734,221,-513,34,473,488
3604,708,365,-343,43,643,658
3605,89,738,649,43,635,650
3606,458,718,260,18,246,261
3607,149,27,-122,58,864,879
3608,795,774,-21,64,965,980
3609,561,451,-110,58,876,891
3610,697,0,-697,23,289,304
3611,478,777,299,22,285,300
3612,666,930,264,18,250,265
3613,113,803,690,45,676,691
3614,467,1,-466,36,520,535
3615,587,826,239,19,225,240
3616,72,991,919,61,905,920
3617,907,864,-43,63,943,958
3618,706,512,-194,53,792,807
3619,409,186,-223,51,763,778
3620,33,12,-21,64,965,980
3621,864,107,-757,18,229,244
3622,114,928,814,54,800,815
3623,593,489,-104,57,882,897
3624,403,707,304,20,290,305
3625,77,707,630,42,616,631
3626,750,214,-536,30,450,465
3627,527,497,-30,63,956,971
3628,785,961,176,12,162,177
3629,106,791,685,46,671,686
3630,481,658,177,13,163,178
3631,478,981,503,35,489,504
3632,535,833,298,21,284,299
3633,580,979,399,29,385,400
3634,171,913,742,49,728,743
3635,355,682,327,24,313,328
3636,352,404,52,5,38,53
3637,58,194,136,10,122,137
3638,726,929,203,16,189,204
3639,111,658,547,37,533,548
3640,842,427,-415,39,571,586
3641,366,361,-5,65,981,996
3642,49,98,49,5,35,50
3643,205,67,-138,57,848,863
3644,354,249,-105,60,881,896
3645,717,729,12,3,6,13
3646,251,247,-4,64,982,997
3647,769,929,160,11,146,161
3648,729,801,72,6,58,73
3649,635,88,-547,31,439,454
3650,608,387,-221,52,765,780
3651,345,672,327,24,313,328
3652,931,442,-489,36,497,512
3653,313,723,410,28,396,411
3654,827,765,-62,61,924,939
3655,266,226,-40,61,946,961
3656,410,852,442,30,428,443
3657,672,632,-40,61,946,961
3658,889,131,-758,17,228,243
3659,242,739,497,33,483,498
3660,81,429,348,24,334,349
3661,19,538,519,36,505,520
3662,892,42,-850,12,136,151
3663,16,954,938,61,924,939
3664,946,423,-523,33,463,478
3665,848,471,-377,43,609,624
3666,975,228,-747,19,239,254
3667,16,700,684,45,670,685
3668,977,392,-585,30,401,416
3669,257,594,337,23,323,338
3670,738,461,-277,48,709,724
3671,40,442,402,27,388,403
3672,413,797,384,25,370,385
3673,746,919,173,14,159,174
3674,938,409,-529,33,457,472
3675,568,244,-324,44,662,677
3676,700,224,-476,35,510,525
3677,701,837,136,10,122,137
3678,414,971,557,38,543,558
3679,515,768,253,19,239,254
3680,408,515,107,10,93,108
3681,732,863,131,11,117,132
3682,636,200,-436,37,550,565
3683,448,814,366,26,352,367
3684,19,41,22,4,8,23
3685,106,350,244,17,230,245
3686,429,919,490,33,476,491
3687,508,322,-186,54,800,815
3688,813,998,185,14,171,186
3689,54,154,100,8,86,101
3690,756,372,-384,40,602,617
3691,176,604,428,29,414,429
3692,778,176,-602,28,384,399
3693,932,836,-96,58,890,905
3694,563,220,-343,43,643,658
3695,700,814,114,9,100,115
3696,328,0,-328,43,658,673
3697,622,784,162,12,148,163
3698,401,126,-275,48,711,726
3699,88,23,-65,62,921,936
3700,240,178,-62,61,924,939
3701,657,114,-543,31,443,458
3702,992,913,-79,60,907,922
3703,502,188,-314,46,672,687
3704,917,441,-476,35,510,525
3705,466,673,207,17,193,208
3706,733,370,-363,43,623,638
3707,966,363,-603,28,383,398
3708,46,117,71,8,57,72
3709,430,311,-119,57,867,882
3710,405,30,-375,41,611,626
3711,491,959,468,31,454,469
3712,778,556,-222,51,764,779
3713,566,421,-145,57,841,856
3714,964,557,-407,39,579,594
3715,1,592,591,41,577,592
3716,93,164,71,8,57,72
3717,779,953,174,14,160,175
3718,252,97,-155,56,831,846
3719,119,804,685,46,671,686
3720,172,897,725,48,711,726
3721,200,941,741,49,727,742
3722,325,883,558,38,544,559
3723,719,917,198,15,184,199
3724,397,143,-254,49,732,747
3725,417,519,102,9,88,103
3726,424,796,372,25,358,373
3727,678,19,-659,24,327,342
3728,275,540,265,19,251,266
3729,824,166,-658,24,328,343
3730,338,606,268,19,254,269
3731,150,330,180,13,166,181
3732,435,791,356,24,342,357
3733,138,348,210,15,196,211
3734,873,822,-51,62,935,950
3735,311,123,-188,53,798,813
3736,844,335,-509,34,477,492
3737,92,630,538,36,524,539
3738,737,712,-25,65,961,976
3739,109,710,601,40,587,602
3740,268,734,466,31,452,467
3741,85,918,833,54,819,834
3742,749,983,234,17,220,235
3743,753,709,-44,62,942,957
3744,888,838,-50,62,936,951
3745,676,861,185,14,171,186
3746,195,855,660,43,646,661
3747,879,381,-498,34,488,503
3748,929,281,-648,23,338,353
3749,606,23,-583,28,403,418
3750,362,245,-117,58,869,884
3751,410,965,555,38,541,556
3752,816,842,26,4,12,27
3753,531,617,86,8,72,87
3754,364,623,259,19,245,260
3755,69,922,853,56,839,854
3756,336,834,498,33,484,499
3757,237,351,114,9,100,115
3758,629,219,-410,40,576,591
3759,630,290,-340,43,646,661
3760,493,288,-205,53,781,796
3761,700,858,158,13,144,159
3762,687,91,-596,27,390,405
3763,344,439,95,10,81,96
3764,984,963,-21,64,965,980
3765,246,699,453,31,439,454
3766,831,449,-382,41,604,619
3767,941,256,-685,23,301,316
3768,846,712,-134,56,852,867
3769,505,493,-12,64,974,989
3770,367,838,471,33,457,472
3771,637,446,-191,53,795,810
3772,343,805,462,32,448,463
3773,347,238,-109,59,877,892
3774,96,728,632,41,618,633
3775,724,134,-590,28,396,411
3776,248,361,113,9,99,114
3777,818,178,-640,24,346,361
3778,342,103,-239,50,747,762
3779,448,471,23,5,9,24
3780,375,404,29,5,15,30
3781,443,754,311,23,297,312
3782,824,537,-287,47,699,714
3783,998,175,-823,13,163,178
3784,797,31,-766,17,220,235
3785,302,54,-248,48,738,753
3786,980,66,-914,8,72,87
3787,755,88,-667,24,319,334
3788,691,157,-534,31,452,467
3789,176,665,489,33,475,490
3790,741,155,-586,29,400,415
3791,356,872,516,34,502,517
3792,880,831,-49,63,937,952
3793,118,608,490,33,476,491
3794,308,196,-112,57,874,889
3795,279,361,82,7,68,83
3796,665,90,-575,29,411,426
3797,551,325,-226,51,760,775
3798,710,203,-507,34,479,494
3799,530,564,34,4,20,35
3800,386,2,-384,40,602,617
3801,869,374,-495,34,491,506
3802,300,995,695,47,681,696
3803,6,363,357,25,343,358
3804,508,29,-479,35,507,522
3805,965,745,-220,51,766,781
3806,64,387,323,23,309,324
3807,265,919,654,44,640,655
3808,623,270,-353,44,633,648
3809,200,341,141,12,127,142
3810,603,738,135,12,121,136
3811,227,521,294,21,280,295
3812,405,94,-311,45,675,690
3813,917,893,-24,62,962,977
3814,23,740,717,48,703,718
3815,6,810,804,52,790,805
3816,428,908,480,31,466,481
3817,12,999,987,65,973,988
3818,853,638,-215,51,771,786
3819,987,706,-281,49,705,720
3820,987,475,-512,32,474,489
3821,853,663,-190,53,796,811
3822,956,477,-479,35,507,522
3823,228,784,556,37,542,557
3824,560,756,196,14,182,197
3825,789,403,-386,41,600,615
3826,631,999,368,24,354,369
3827,456,84,-372,41,614,629
3828,848,680,-168,53,818,833
3829,339,159,-180,53,806,821
3830,614,828,214,16,200,215
3831,770,724,-46,62,940,955
3832,305,274,-31,63,955,970
3833,565,785,220,16,206,221
3834,132,852,720,46,706,721
3835,267,336,69,7,55,70
3836,356,122,-234,51,752,767
3837,97,462,365,26,351,366
3838,368,229,-139,57,847,862
3839,668,879,211,16,197,212
3840,407,310,-97,60,889,904
3841,843,258,-585,30,401,416
3842,315,173,-142,56,844,859
3843,479,228,-251,50,735,750
3844,516,843,327,24,313,328
3845,133,325,192,13,178,193
3846,276,935,659,44,645,660
3847,639,101,-538,32,448,463
3848,38,703,665,44,651,666
3849,231,361,130,10,116,131
3850,50,477,427,30,413,428
3851,642,571,-71,60,915,930
3852,404,528,124,10,110,125
3853,175,865,690,45,676,691
3854,692,217,-475,36,511,526
3855,112,273,161,12,147,162
3856,396,35,-361,44,625,640
3857,485,104,-381,42,605,620
3858,352,987,635,43,621,636
3859,887,554,-333,45,653,668
3860,451,454,3,3,3,4
3861,158,46,-112,57,874,889
3862,698,91,-607,27,379,394
3863,228,295,67,7,53,68
3864,587,774,187,15,173,188
3865,697,395,-302,46,684,699
3866,485,625,140,11,126,141
3867,514,116,-398,40,588,603
3868,812,102,-710,20,276,291
3869,570,897,327,24,313,328
3870,882,759,-123,58,863,878
3871,325,247,-78,60,908,923
3872,792,264,-528,31,458,473
3873,294,221,-73,62,913,928
3874,939,131,-808,13,178,193
3875,922,306,-616,25,370,385
3876,564,684,120,9,106,121
3877,740,952,212,15,198,213
3878,259,54,-205,53,781,796
3879,35,370,335,25,321,336
3880,990,746,-244,49,742,757
3881,266,170,-96,58,890,905
3882,195,750,555,38,541,556
3883,908,365,-543,31,443,458
3884,107,725,618,41,604,619
3885,191,359,168,12,154,169
3886,704,606,-98,59,888,903
3887,407,410,3,3,3,4
3888,298,951,653,44,639,654
3889,841,783,-58,62,928,943
3890,615,943,328,22,314,329
3891,153,262,109,10,95,110
3892,584,75,-509,34,477,492
3893,869,712,-157,56,829,844
3894,363,875,512,33,498,513
3895,628,931,303,23,289,304
3896,427,280,-147,56,839,854
3897,460,293,-167,54,819,834
3898,844,155,-689,23,297,312
3899,502,513,11,4,5,12
3900,483,520,37,5,23,38
3901,550,981,431,31,417,432
3902,697,155,-542,31,444,459
3903,580,769,189,15,175,190
3904,242,561,319,24,305,320
3905,474,429,-45,63,941,956
3906,487,140,-347,44,639,654
3907,588,821,233,17,219,234
3908,958,659,-299,47,687,702
3909,122,823,701,47,687,702
3910,48,984,936,60,922,937
3911,6,210,204,15,190,205
3912,540,822,282,20,268,283
3913,428,778,350,25,336,351
3914,186,641,455,32,441,456
3915,95,405,310,22,296,311
3916,766,416,-350,43,636,651
3917,370,776,406,28,392,407
3918,936,427,-509,34,477,492
3919,647,428,-219,52,767,782
3920,972,336,-636,25,350,365
3921,566,940,374,26,360,375
3922,425,989,564,37,550,565
3923,391,340,-51,62,935,950
3924,597,620,23,5,9,24
3925,566,239,-327,44,659,674
3926,634,386,-248,48,738,753
3927,584,838,254,19,240,255
3928,733,220,-513,34,473,488
3929,607,830,223,18,209,224
3930,539,850,311,23,297,312
3931,474,925,451,31,437,452
3932,443,754,311,23,297,312
3933,587,49,-538,32,448,463
3934,136,91,-45,63,941,956
3935,417,632,215,17,201,216
3936,152,6,-146,56,840,855
3937,173,308,135,12,121,136
3938,928,399,-529,33,457,472
3939,174,429,255,20,241,256
3940,699,758,59,7,45,60
3941,580,159,-421,39,565,580
3942,424,406,-18,64,968,983
3943,848,881,33,4,19,34
3944,520,312,-208,51,778,793
3945,911,512,-399,40,587,602
3946,816,725,-91,60,895,910
3947,988,565,-423,38,563,578
3948,106,183,77,8,63,78
3949,793,663,-130,57,856,871
3950,869,143,-726,19,260,275
3951,272,663,391,28,377,392
3952,211,155,-56,60,930,945
3953,328,826,498,33,484,499
3954,957,657,-300,46,686,701
3955,202,628,426,29,412,427
3956,73,931,858,56,844,859
3957,34,745,711,48,697,712
3958,139,338,199,16,185,200
3959,602,33,-569,31,417,432
3960,712,932,220,16,206,221
3961,922,929,7,4,5,8
3962,424,324,-100,58,886,901
3963,289,699,410,28,396,411
3964,465,307,-158,55,828,843
3965,178,844,666,44,652,667
3966,590,190,-400,39,586,601
3967,390,195,-195,53,791,806
3968,588,867,279,21,265,280
3969,869,952,83,8,69,84
3970,518,588,70,7,56,71
3971,772,948,176,12,162,177
3972,758,568,-190,53,796,811
3973,787,239,-548,30,438,453
3974,946,999,53,6,39,54
3975,62,275,213,16,199,214
3976,506,211,-295,46,691,706
3977,488,678,190,15,176,191
3978,321,552,231,18,217,232
3979,175,278,103,10,89,104
3980,540,84,-456,35,530,545
3981,955,437,-518,32,468,483
3982,968,119,-849,13,137,152
3983,131,294,163,13,149,164
3984,865,582,-283,48,703,718
3985,609,750,141,12,127,142
3986,420,782,362,25,348,363
3987,352,806,454,31,440,455
3988,406,637,231,18,217,232
3989,771,726,-45,63,941,956
3990,934,618,-316,45,670,685
3991,836,414,-422,38,564,579
3992,115,171,56,5,42,57
3993,49,54,5,3,3,6
3994,645,552,-93,60,893,908
3995,723,483,-240,49,746,761
3996,627,829,202,15,188,203
3997,655,411,-244,49,742,757
3998,918,120,-798,15,188,203
3999,566,606,40,4,26,41
4000,44,790,746,49,732,747
4001,337,538,201,15,187,202
4002,517,983,466,31,452,467
4003,196,81,-115,58,871,886
4004,474,713,239,19,225,240
4005,615,363,-252,49,734,749
4006,702,955,253,19,239,254
4007,28,788,760,49,746,761
4008,994,16,-978,4,8,23
4009,114,534,420,28,406,421
4010,630,748,118,10,104,119
4011,404,641,237,18,223,238
4012,677,71,-606,27,380,395
4013,808,481,-327,44,659,674
4014,92,349,257,18,243,258
4015,134,926,792,51,778,793
4016,454,234,-220,51,766,781
4017,697,940,243,18,229,244
4018,934,711,-223,51,763,778
4019,414,103,-311,45,675,690
4020,672,210,-462,36,524,539
4021,364,537,173,14,159,174
4022,287,329,42,5,28,43
4023,64,513,449,30,435,450
4024,854,263,-591,28,395,410
4025,104,652,548,36,534,549
4026,818,94,-724,19,262,277
4027,614,694,80,6,66,81
4028,240,347,107,10,93,108
4029,411,61,-350,43,636,651
4030,88,3,-85,60,901,916
4031,773,606,-167,54,819,834
4032,418,850,432,28,418,433
4033,607,53,-554,31,432,447
4034,345,946,601,40,587,602
4035,978,203,-775,16,211,226
4036,897,129,-768,16,218,233
4037,835,168,-667,24,319,334
4038,460,50,-410,40,576,591
4039,242,38,-204,52,782,797
4040,490,506,16,2,2,17
4041,176,758,582,39,568,583
4042,485,117,-368,41,618,633
4043,411,779,368,24,354,369
4044,223,452,229,17,215,230
4045,517,795,278,20,264,279
4046,826,308,-518,32,468,483
4047,766,78,-688,21,298,313
4048,478,325,-153,57,833,848
4049,559,685,126,11,112,127
4050,227,103,-124,57,862,877
4051,632,749,117,10,103,118
4052,587,917,330,23,316,331
4053,837,77,-760,16,226,241
4054,797,6,-791,15,195,210
4055,948,253,-695,21,291,306
4056,511,844,333,24,319,334
4057,483,404,-79,60,907,922
4058,910,801,-109,59,877,892
4059,12,194,182,14,168,183
4060,850,678,-172,54,814,829
4061,122,165,43,6,29,44
4062,537,640,103,10,89,104
4063,737,698,-39,62,947,962
4064,259,775,516,34,502,517
4065,94,18,-76,60,910,925
4066,842,531,-311,45,675,690
4067,942,257,-685,23,301,316
4068,467,789,322,22,308,323
4069,693,827,134,11,120,135
4070,997,625,-372,41,614,629
4071,329,53,-276,47,710,725
4072,9,183,174,14,160,175
4073,783,777,-6,64,980,995
4074,993,306,-687,22,299,314
4075,572,693,121,10,107,122
4076,448,159,-289,48,697,712
4077,187,859,672,43,658,673
4078,265,657,392,26,378,393
4079,684,229,-455,36,531,546
4080,450,805,355,25,341,356
4081,482,66,-416,38,570,585
4082,793,704,-89,61,897,912
4083,772,201,-571,30,415,430
4084,934,699,-235,51,751,766
4085,620,923,303,23,289,304
4086,633,599,-34,63,952,967
4087,71,116,45,6,31,46
4088,544,60,-484,34,502,517
4089,309,869,560,36,546,561
4090,890,546,-344,42,642,657
4091,323,369,46,6,32,47
4092,55,267,212,15,198,213
4093,832,43,-789,16,197,212
4094,359,885,526,36,512,527
4095,440,65,-375,41,611,626
4096,850,806,-44,62,942,957
4097,184,369,185,14,171,186
4098,605,144,-461,37,525,540
4099,378,24,-354,43,632,647
4100,108,802,694,46,680,695
4101,173,140,-33,64,953,968
4102,751,686,-65,62,921,936
4103,196,953,757,50,743,758
4104,112,672,560,36,546,561
4105,962,51,-911,8,75,90
4106,56,983,927,62,913,928
4107,399,636,237,18,223,238
4108,449,775,326,23,312,327
4109,40,880,840,54,826,841
4110,785,23,-762,18,224,239
4111,894,623,-271,48,715,730
4112,887,592,-295,46,691,706
4113,126,961,835,55,821,836
4114,724,874,150,12,136,151
4115,619,825,206,16,192,207
4116,721,980,259,19,245,260
4117,550,601,51,6,37,52
4118,89,337,248,17,234,249
4119,775,936,161,12,147,162
4120,823,800,-23,63,963,978
4121,690,748,58,6,44,59
4122,72,609,537,36,523,538
4123,108,538,430,30,416,431
4124,140,724,584,38,570,585
4125,721,100,-621,27,365,380
4126,578,444,-134,56,852,867
4127,381,761,380,26,366,381
4128,878,597,-281,49,705,720
4129,70,24,-46,62,940,955
4130,706,402,-304,45,682,697
4131,28,32,4,2,2,5
4132,520,198,-322,45,664,679
4133,166,409,243,18,229,244
4134,406,544,138,11,124,139
4135,469,917,448,29,434,449
4136,73,227,154,12,140,155
4137,454,246,-208,51,778,793
4138,365,617,252,18,238,253
4139,218,937,719,49,705,720
4140,18,747,729,48,715,730
4141,42,915,873,57,859,874
4142,78,522,444,30,430,445
4143,640,993,353,24,339,354
4144,762,173,-589,29,397,412
4145,409,46,-363,43,623,638
4146,956,166,-790,15,196,211
4147,583,165,-418,39,568,583
4148,378,138,-240,49,746,761
4149,906,846,-60,61,926,941
4150,369,115,-254,49,732,747
4151,63,227,164,12,150,165
4152,641,245,-396,40,590,605
4153,202,930,728,47,714,729
4154,424,843,419,29,405,420
4155,23,185,162,12,148,163
4156,558,146,-412,39,574,589
4157,97,739,642,42,628,643
4158,489,775,286,21,272,287
4159,181,729,548,36,534,549
4160,252,698,446,31,432,447
4161,88,155,67,7,53,68
4162,390,940,550,37,536,551
4163,724,78,-646,24,340,355
4164,257,328,71,8,57,72
4165,246,310,64,5,50,65
4166,71,658,587,40,573,588
4167,105,230,125,11,111,126
4168,138,472,334,24,320,335
4169,684,642,-42,63,944,959
4170,733,8,-725,20,261,276
4171,739,179,-560,29,426,441
4172,789,513,-276,47,710,725
4173,937,937,0,1,1,1
4174,346,874,528,34,514,529
4175,375,467,92,8,78,93
4176,97,66,-31,63,955,970
4177,775,17,-758,17,228,243
4178,701,189,-512,32,474,489
4179,379,48,-331,45,655,670
4180,938,906,-32,62,954,969
4181,742,994,252,18,238,253
4182,348,142,-206,52,780,795
4183,704,668,-36,62,950,965
4184,523,949,426,29,412,427
4185,567,214,-353,44,633,648
4186,146,417,271,21,257,272
4187,886,674,-212,51,774,789
4188,798,765,-33,64,953,968
4189,232,328,96,7,82,97
4190,491,824,333,24,319,334
4191,22,71,49,5,35,50
4192,784,62,-722,20,264,279
4193,131,166,35,5,21,36
4194,535,94,-441,39,545,560
4195,840,61,-779,17,207,222
4196,767,669,-98,59,888,903
4197,197,998,801,52,787,802
4198,732,514,-218,52,768,783
4199,215,720,505,34,491,506
4200,549,904,355,25,341,356
4201,751,859,108,9,94,109
4202,115,177,62,7,48,63
4203,236,308,72,6,58,73
4204,124,667,543,38,529,544
4205,396,265,-131,57,855,870
4206,126,968,842,55,828,843
4207,897,252,-645,25,341,356
4208,46,128,82,7,68,83
4209,841,658,-183,53,803,818
4210,54,143,89,8,75,90
4211,729,878,149,12,135,150
4212,949,283,-666,24,320,335
4213,978,852,-126,57,860,875
4214,446,481,35,5,21,36
4215,134,780,646,43,632,647
4216,212,506,294,21,280,295
4217,834,442,-392,39,594,609
4218,550,499,-51,62,935,950
4219,739,250,-489,36,497,512
4220,63,938,875,58,861,876
4221,239,264,25,4,11,26
4222,719,213,-506,34,480,495
4223,351,529,178,13,164,179
4224,602,131,-471,35,515,530
4225,17,783,766,51,752,767
4226,4,930,926,61,912,927
4227,783,668,-115,58,871,886
4228,902,533,-369,43,617,632
4229,917,143,-774,16,212,227
4230,282,983,701,47,687,702
4231,476,293,-183,53,803,818
4232,274,442,168,12,154,169
4233,74,495,421,29,407,422
4234,951,46,-905,10,81,96
4235,635,13,-622,26,364,379
4236,822,600,-222,51,764,779
4237,336,82,-254,49,732,747
4238,875,687,-188,53,798,813
4239,646,862,216,15,202,217
4240,937,913,-24,62,962,977
4241,121,67,-54,61,932,947
4242,704,35,-669,24,317,332
4243,678,157,-521,34,465,480
4244,509,918,409,28,395,410
4245,75,672,597,40,583,598
4246,321,882,561,37,547,562
4247,412,652,240,16,226,241
4248,741,963,222,17,208,223
4249,163,106,-57,63,929,944
4250,313,690,377,26,363,378
4251,266,81,-185,55,801,816
4252,641,310,-331,45,655,670
4253,535,17,-518,32,468,483
4254,852,851,-1,66,985,1000
4255,649,518,-131,57,855,870
4256,283,384,101,9,87,102
4257,674,973,299,22,285,300
4258,623,739,116,9,102,117
4259,395,670,275,20,261,276
4260,373,948,575,40,561,576
4261,411,628,217,16,203,218
4262,859,584,-275,48,711,726
4263,18,989,971,64,957,972
4264,538,135,-403,40,583,598
4265,819,761,-58,62,928,943
4266,570,801,231,18,217,232
4267,907,299,-608,26,378,393
4268,660,607,-53,62,933,948
4269,804,6,-798,15,188,203
4270,114,102,-12,64,974,989
4271,958,379,-579,29,407,422
4272,712,201,-511,33,475,490
4273,379,771,392,26,378,393
4274,540,875,335,25,321,336
4275,603,508,-95,59,891,906
4276,340,632,292,20,278,293
4277,788,469,-319,45,667,682
4278,555,937,382,27,368,383
4279,427,946,519,36,505,520
4280,758,414,-344,42,642,657
4281,372,245,-127,57,859,874
4282,829,329,-500,33,486,501
4283,332,71,-261,49,725,740
4284,319,723,404,27,390,405
4285,801,529,-272,47,714,729
4286,277,232,-45,63,941,956
4287,87,962,875,58,861,876
4288,852,629,-223,51,763,778
4289,187,895,708,46,694,709
4290,123,910,787,52,773,788
4291,826,349,-477,36,509,524
4292,246,371,125,11,111,126
4293,827,779,-48,61,938,953
4294,467,881,414,29,400,415
4295,921,536,-385,42,601,616
4296,424,284,-140,56,846,861
4297,916,695,-221,52,765,780
4298,879,988,109,10,95,110
4299,876,777,-99,59,887,902
4300,272,769,497,33,483,498
4301,202,563,361,25,347,362
4302,51,50,-1,66,985,1000
4303,18,391,373,26,359,374
4304,143,240,97,8,83,98
4305,284,76,-208,51,778,793
4306,555,836,281,20,267,282
4307,469,538,69,7,55,70
4308,666,845,179,14,165,180
4309,473,299,-174,54,812,827
4310,731,675,-56,60,930,945
4311,788,96,-692,21,294,309
4312,425,4,-421,39,565,580
4313,108,864,756,49,742,757
4314,338,426,88,7,74,89
4315,230,817,587,40,573,588
4316,46,772,726,48,712,727
4317,989,31,-958,5,28,43
4318,141,706,565,38,551,566
4319,658,368,-290,47,696,711
4320,449,500,51,6,37,52
4321,99,746,647,44,633,648
4322,396,285,-111,58,875,890
4323,944,350,-594,28,392,407
4324,605,231,-374,41,612,627
4325,23,779,756,49,742,757
4326,538,512,-26,64,960,975
4327,140,254,114,9,100,115
4328,110,232,122,10,108,123
4329,834,800,-34,63,952,967
4330,262,69,-193,54,793,808
4331,587,797,210,15,196,211
4332,435,280,-155,56,831,846
4333,674,151,-523,33,463,478
4334,329,844,515,35,501,516
4335,778,592,-186,54,800,815
4336,674,55,-619,27,367,382
4337,398,520,122,10,108,123
4338,664,960,296,20,282,297
4339,963,939,-24,62,962,977
4340,789,756,-33,64,953,968
4341,820,48,-772,16,214,229
4342,519,51,-468,35,518,533
4343,422,166,-256,48,730,745
4344,914,491,-423,38,563,578
4345,826,262,-564,29,422,437
4346,96,358,262,19,248,263
4347,605,912,307,22,293,308
4348,580,425,-155,56,831,846
4349,96,395,299,22,285,300
4350,361,106,-255,49,731,746
4351,151,283,132,10,118,133
4352,648,293,-355,43,631,646
4353,866,921,55,7,41,56
4354,876,185,-691,22,295,310
4355,358,997,639,44,625,640
4356,721,787,66,6,52,67
4357,660,146,-514,33,472,487
4358,980,944,-36,62,950,965
4359,788,970,182,14,168,183
4360,477,462,-15,64,971,986
4361,392,998,606,41,592,607
4362,292,200,-92,59,894,909
4363,310,950,640,41,626,641
4364,681,484,-197,53,789,804
4365,16,290,274,19,260,275
4366,69,943,874,57,860,875
4367,585,512,-73,62,913,928
4368,475,481,6,3,4,7
4369,755,645,-110,58,876,891
4370,780,662,-118,57,868,883
4371,429,214,-215,51,771,786
4372,422,438,16,2,2,17
4373,16,611,595,40,581,596
4374,835,505,-330,45,656,671
4375,908,456,-452,36,534,549
4376,404,878,474,32,460,475
4377,433,991,558,38,544,559
4378,421,17,-404,39,582,597
4379,454,335,-119,57,867,882
4380,736,824,88,7,74,89
4381,902,788,-114,58,872,887
4382,558,954,396,27,382,397
4383,563,151,-412,39,574,589
4384,763,142,-621,27,365,380
4385,372,406,34,4,20,35
4386,785,396,-389,41,597,612
4387,721,252,-469,36,517,532
4388,245,935,690,45,676,691
4389,363,151,-212,51,774,789
4390,684,928,244,17,230,245
4391,855,348,-507,34,479,494
4392,531,563,32,3,18,33
4393,825,907,82,7,68,83
4394,991,849,-142,56,844,859
4395,768,430,-338,44,648,663
4396,231,853,622,42,608,623
4397,528,387,-141,57,845,860
4398,756,190,-566,29,420,435
4399,844,34,-810,15,176,191
4400,821,851,30,5,16,31
4401,401,519,118,10,104,119
4402,103,734,631,43,617,632
4403,610,742,132,10,118,133
4404,833,459,-374,41,612,627
4405,354,500,146,11,132,147
4406,487,894,407,29,393,408
4407,344,984,640,41,626,641
4408,477,657,180,13,166,181
4409,932,745,-187,54,799,814
4410,974,708,-266,49,720,735
4411,542,452,-90,60,896,911
4412,187,367,180,13,166,181
4413,39,635,596,39,582,597
4414,357,292,-65,62,921,936
4415,600,909,309,22,295,310
4416,29,808,779,52,765,780
4417,892,344,-548,30,438,453
4418,209,920,711,48,697,712
4419,911,692,-219,52,767,782
4420,636,914,278,20,264,279
4421,434,421,-13,65,973,988
4422,254,123,-131,57,855,870
4423,281,611,330,23,316,331
4424,511,794,283,21,269,284
4425,640,634,-6,64,980,995
4426,549,21,-528,31,458,473
4427,975,725,-250,50,736,751
4428,527,376,-151,55,835,850
4429,588,642,54,6,40,55
4430,68,904,836,54,822,837
4431,24,156,132,10,118,133
4432,655,768,113,9,99,114
4433,634,220,-414,39,572,587
4434,144,612,468,31,454,469
4435,902,589,-313,47,673,688
4436,220,963,743,50,729,744
4437,26,458,432,28,418,433
4438,564,718,154,12,140,155
4439,305,237,-68,60,918,933
4440,951,250,-701,22,285,300
4441,215,977,762,50,748,763
4442,172,990,818,53,804,819
4443,565,175,-390,40,596,611
4444,97,551,454,31,440,455
4445,727,851,124,10,110,125
4446,19,163,144,10,130,145
4447,388,39,-349,44,637,652
4448,840,206,-634,26,352,367
4449,203,76,-127,57,859,874
4450,410,852,442,30,428,443
4451,645,202,-443,38,543,558
4452,974,270,-704,20,282,297
4453,219,977,758,50,744,759
4454,185,808,623,43,609,624
4455,842,324,-518,32,468,483
4456,360,332,-28,63,958,973
4457,918,129,-789,16,197,212
4458,764,121,-643,25,343,358
4459,237,224,-13,65,973,988
4460,925,766,-159,55,827,842
4461,237,312,75,8,61,76
4462,140,556,416,27,402,417
4463,162,297,135,12,121,136
4464,978,216,-762,18,224,239
4465,129,124,-5,65,981,996
4466,942,109,-833,14,153,168
4467,675,950,275,20,261,276
4468,431,618,187,15,173,188
4469,143,355,212,15,198,213
4470,666,964,298,21,284,299
4471,659,407,-252,49,734,749
4472,393,117,-276,47,710,725
4473,402,445,43,6,29,44
4474,542,99,-443,38,543,558
4475,891,533,-358,42,628,643
4476,416,876,460,31,446,461
4477,974,931,-43,63,943,958
4478,657,692,35,5,21,36
4479,547,733,186,14,172,187
4480,430,592,162,12,148,163
4481,154,793,639,44,625,640
4482,538,268,-270,48,716,731
4483,41,800,759,51,745,760
4484,27,650,623,43,609,624
4485,437,913,476,32,462,477
4486,633,541,-92,59,894,909
4487,790,95,-695,21,291,306
4488,152,313,161,12,147,162
4489,742,153,-589,29,397,412
4490,445,382,-63,61,923,938
4491,86,589,503,35,489,504
4492,804,909,105,9,91,106
4493,787,31,-756,17,230,245
4494,421,571,150,12,136,151
4495,682,135,-547,31,439,454
4496,129,629,500,33,486,501
4497,906,52,-854,11,132,147
4498,460,643,183,15,169,184
4499,415,488,73,7,59,74
4500,419,91,-328,43,658,673
4501,991,451,-540,31,446,461
4502,977,746,-231,50,755,770
4503,755,543,-212,51,774,789
4504,203,440,237,18,223,238
4505,254,837,583,40,569,584
4506,574,707,133,11,119,134
4507,149,628,479,34,465,480
4508,333,21,-312,44,674,689
4509,748,130,-618,27,368,383
4510,226,973,747,50,733,748
4511,134,626,492,33,478,493
4512,909,354,-555,31,431,446
4513,986,392,-594,28,392,407
4514,46,259,213,16,199,214
4515,808,115,-693,22,293,308
4516,53,471,418,28,404,419
4517,369,932,563,38,549,564
4518,999,193,-806,14,180,195
4519,793,487,-306,46,680,695
4520,929,905,-24,62,962,977
4521,414,885,471,33,457,472
4522,793,350,-443,38,543,558
4523,684,740,56,5,42,57
4524,825,225,-600,26,386,401
4525,467,665,198,15,184,199
4526,240,836,596,39,582,597
4527,825,356,-469,36,517,532
4528,542,715,173,14,159,174
4529,69,557,488,32,474,489
4530,516,500,-16,63,970,985
4531,195,835,640,41,626,641
4532,526,519,-7,64,979,994
4533,750,31,-719,20,267,282
4534,712,902,190,15,176,191
4535,480,391,-89,61,897,912
4536,178,514,336,22,322,337
4537,925,974,49,5,35,50
4538,253,618,365,26,351,366
4539,622,790,168,12,154,169
4540,851,408,-443,38,543,558
4541,298,790,492,33,478,493
4542,516,530,14,4,8,15
4543,38,144,106,9,92,107
4544,44,643,599,41,585,600
4545,418,910,492,33,478,493
4546,770,304,-466,36,520,535
4547,577,665,88,7,74,89
4548,488,867,379,27,365,380
4549,892,45,-847,12,139,154
4550,220,127,-93,60,893,908
4551,307,246,-61,62,925,940
4552,167,748,581,39,567,582
4553,372,266,-106,59,880,895
4554,635,593,-42,63,944,959
4555,171,270,99,9,85,100
4556,413,532,119,11,105,120
4557,73,629,556,37,542,557
4558,68,82,14,4,8,15
4559,832,310,-522,33,464,479
4560,186,905,719,49,705,720
4561,304,4,-300,46,686,701
4562,540,747,207,17,193,208
4563,937,533,-404,39,582,597
4564,654,676,22,4,8,23
4565,339,497,158,13,144,159
4566,41,719,678,45,664,679
4567,780,575,-205,53,781,796
4568,374,667,293,21,279,294
4569,862,133,-729,21,257,272
4570,928,777,-151,55,835,850
4571,536,373,-163,55,823,838
4572,912,339,-573,30,413,428
4573,51,251,200,14,186,201
4574,540,570,30,5,16,31
4575,584,991,407,29,393,408
4576,683,168,-515,33,471,486
4577,703,281,-422,38,564,579
4578,480,491,11,4,5,12
4579,147,290,143,13,129,144
4580,265,206,-59,62,927,942
4581,297,279,-18,64,968,983
4582,494,167,-327,44,659,674
4583,170,840,670,45,656,671
4584,827,98,-729,21,257,272
4585,771,802,31,6,17,32
4586,749,962,213,16,199,214
4587,239,924,685,46,671,686
4588,639,389,-250,50,736,751
4589,769,598,-171,55,815,830
4590,0,178,178,13,164,179
4591,408,969,561,37,547,562
4592,522,587,65,6,51,66
4593,975,98,-877,11,109,124
4594,163,812,649,43,635,650
4595,407,180,-227,51,759,774
4596,365,557,192,13,178,193
4597,228,217,-11,65,975,990
4598,885,750,-135,56,851,866
4599,387,876,489,33,475,490
4600,323,751,428,29,414,429
4601,584,886,302,22,288,303
4602,633,661,28,4,14,29
4603,164,571,407,29,393,408
4604,825,651,-174,54,812,827
4605,950,155,-795,16,191,206
4606,323,633,310,22,296,311
4607,347,184,-163,55,823,838
4608,163,726,563,38,549,564
4609,640,52,-588,28,398,413
4610,872,954,82,7,68,83
4611,115,260,145,11,131,146
4612,551,190,-361,44,625,640
4613,972,597,-375,41,611,626
4614,433,55,-378,42,608,623
4615,162,786,624,40,610,625
4616,25,997,972,63,958,973
4617,318,356,38,5,24,39
4618,923,463,-460,36,526,541
4619,473,905,432,28,418,433
4620,279,257,-22,63,964,979
4621,713,909,196,14,182,197
4622,634,761,127,12,113,128
4623,863,533,-330,45,656,671
4624,652,851,199,16,185,200
4625,497,218,-279,47,707,722
4626,360,874,514,34,500,515
4627,415,749,334,24,320,335
4628,806,323,-483,35,503,518
4629,456,438,-18,64,968,983
4630,800,220,-580,28,406,421
4631,536,696,160,11,146,161
4632,574,844,270,20,256,271
4633,843,562,-281,49,705,720
4634,347,445,98,8,84,99
4635,28,695,667,45,653,668
4636,169,525,356,24,342,357
4637,581,276,-305,47,681,696
4638,734,459,-275,48,711,726
4639,560,934,374,26,360,375
4640,670,115,-555,31,431,446
4641,496,250,-246,49,740,755
4642,274,92,-182,53,804,819
4643,562,74,-488,33,498,513
4644,805,506,-299,47,687,702
4645,870,678,-192,52,794,809
4646,698,917,219,17,205,220
4647,66,37,-29,64,957,972
4648,10,232,222,17,208,223
4649,174,290,116,9,102,117
4650,371,353,-18,64,968,983
4651,692,230,-462,36,524,539
4652,702,823,121,10,107,122
4653,917,128,-789,16,197,212
4654,64,501,437,30,423,438
4655,626,39,-587,29,399,414
4656,771,582,-189,54,797,812
4657,780,788,8,2,2,9
4658,491,437,-54,61,932,947
4659,286,965,679,46,665,680
4660,977,169,-808,13,178,193
4661,918,736,-182,53,804,819
4662,298,572,274,19,260,275
4663,66,788,722,47,708,723
4664,918,177,-741,19,245,260
4665,282,779,497,33,483,498
4666,566,631,65,6,51,66
4667,42,130,88,7,74,89
4668,437,416,-21,64,965,980
4669,907,172,-735,19,251,266
4670,545,303,-242,50,744,759
4671,23,338,315,23,301,316
4672,170,636,466,31,452,467
4673,360,697,337,23,323,338
4674,359,786,427,30,413,428
4675,797,207,-590,28,396,411
4676,808,1,-807,14,179,194
4677,716,793,77,8,63,78
4678,711,227,-484,34,502,517
4679,953,619,-334,44,652,667
4680,96,565,469,32,455,470
4681,905,640,-265,50,721,736
4682,900,485,-415,39,571,586
4683,478,962,484,32,470,485
4684,290,909,619,42,605,620
4685,890,257,-633,27,353,368
4686,231,910,679,46,665,680
4687,942,892,-50,62,936,951
4688,818,950,132,10,118,133
4689,785,558,-227,51,759,774
4690,803,277,-526,32,460,475
4691,947,912,-35,63,951,966
4692,182,223,41,5,27,42
4693,852,192,-660,23,326,341
4694,619,528,-91,60,895,910
4695,507,721,214,16,200,215
4696,215,295,80,6,66,81
4697,174,556,382,27,368,383
4698,146,918,772,50,758,773
4699,226,22,-204,52,782,797
4700,767,615,-152,54,834,849
4701,491,46,-445,38,541,556
4702,487,617,130,10,116,131
4703,75,327,252,18,238,253
4704,539,715,176,12,162,177
4705,813,869,56,5,42,57
4706,259,470,211,16,197,212
4707,381,637,256,17,242,257
4708,144,250,106,9,92,107
4709,50,797,747,50,733,748
4710,43,991,948,61,934,949
4711,720,628,-92,59,894,909
4712,419,40,-379,42,607,622
4713,59,616,557,38,543,558
4714,715,104,-611,27,375,390
4715,903,856,-47,62,939,954
4716,816,316,-500,33,486,501
4717,508,659,151,13,137,152
4718,393,994,601,40,587,602
4719,668,487,-181,54,805,820
4720,60,161,101,9,87,102
4721,306,483,177,13,163,178
4722,420,406,-14,64,972,987
4723,450,232,-218,52,768,783
4724,246,780,534,36,520,535
4725,57,43,-14,64,972,987
4726,435,227,-208,51,778,793
4727,310,590,280,19,266,281
4728,58,726,668,44,654,669
4729,400,815,415,30,401,416
4730,370,3,-367,42,619,634
4731,708,342,-366,42,620,635
4732,220,711,491,34,477,492
4733,576,354,-222,51,764,779
4734,18,670,652,43,638,653
4735,510,640,130,10,116,131
4736,465,408,-57,63,929,944
4737,78,916,838,55,824,839
4738,924,291,-633,27,353,368
4739,329,131,-198,52,788,803
4740,291,680,389,27,375,390
4741,122,626,504,33,490,505
4742,398,504,106,9,92,107
4743,512,632,120,9,106,121
4744,252,717,465,31,451,466
4745,792,790,-2,65,984,999
4746,434,603,169,13,155,170
4747,652,831,179,14,165,180
4748,917,681,-236,50,750,765
4749,434,733,299,22,285,300
4750,627,615,-12,64,974,989
4751,331,848,517,35,503,518
4752,370,294,-76,60,910,925
4753,485,601,116,9,102,117
4754,41,305,264,18,250,265
4755,457,337,-120,56,866,881
4756,363,845,482,32,468,483
4757,318,554,236,17,222,237
4758,407,11,-396,40,590,605
4759,768,294,-474,36,512,527
4760,681,408,-273,49,713,728
4761,164,27,-137,58,849,864
4762,782,917,135,12,121,136
4763,275,594,319,24,305,320
4764,580,178,-402,40,584,599
4765,487,311,-176,53,810,825
4766,787,729,-58,62,928,943
4767,438,348,-90,60,896,911
4768,892,495,-397,41,589,604
4769,891,69,-822,13,164,179
4770,449,473,24,3,10,25
4771,380,493,113,9,99,114
4772,848,658,-190,53,796,811
4773,649,945,296,20,282,297
4774,306,539,233,17,219,234
4775,734,275,-459,37,527,542
4776,38,301,263,20,249,264
4777,213,652,439,31,425,440
4778,145,284,139,12,125,140
4779,777,352,-425,40,561,576
4780,161,436,275,20,261,276
4781,376,545,169,13,155,170
4782,397,142,-255,49,731,746
4783,422,265,-157,56,829,844
4784,196,515,319,24,305,320
4785,89,468,379,27,365,380
4786,684,954,270,20,256,271
4787,479,983,504,33,490,505
4788,173,900,727,49,713,728
4789,686,454,-232,49,754,769
4790,489,704,215,17,201,216
4791,889,860,-29,64,957,972
4792,663,658,-5,65,981,996
4793,44,366,322,22,308,323
4794,295,237,-58,62,928,943
4795,834,410,-424,37,562,577
4796,828,247,-581,29,405,420
4797,189,253,64,5,50,65
4798,985,369,-616,25,370,385
4799,955,169,-786,16,200,215
4800,107,563,456,30,442,457
4801,364,316,-48,61,938,953
4802,890,49,-841,14,145,160
4803,952,135,-817,15,169,184
4804,778,555,-223,51,763,778
4805,140,137,-3,65,983,998
4806,78,516,438,30,424,439
4807,517,449,-68,60,918,933
4808,895,284,-611,27,375,390
4809,554,461,-93,60,893,908
4810,781,35,-746,19,240,255
4811,551,690,139,12,125,140
4812,444,741,297,21,283,298
4813,661,316,-345,45,641,656
4814,497,100,-397,41,589,604
4815,976,78,-898,9,88,103
4816,641,127,-514,33,472,487
4817,44,422,378,26,364,379
4818,917,100,-817,15,169,184
4819,3,16,13,4,7,14
4820,490,429,-61,62,925,940
4821,302,124,-178,54,808,823
4822,256,778,522,35,508,523
4823,984,565,-419,39,567,582
4824,388,656,268,19,254,269
4825,126,497,371,26,357,372
4826,563,861,298,21,284,299
4827,58,241,183,15,169,184
4828,245,353,108,9,94,109
4829,741,527,-214,51,772,787
4830,823,547,-276,47,710,725
4831,136,105,-31,63,955,970
4832,154,640,486,33,472,487
4833,486,143,-343,43,643,658
4834,171,643,472,31,458,473
4835,945,937,-8,63,978,993
4836,157,116,-41,64,945,960
4837,300,667,367,27,353,368
4838,372,93,-279,47,707,722
4839,300,993,693,46,679,694
4840,918,507,-411,40,575,590
4841,265,659,394,27,380,395
4842,591,178,-413,40,573,588
4843,929,945,16,2,2,17
4844,634,903,269,20,255,270
4845,89,50,-39,62,947,962
4846,293,450,157,13,143,158
4847,694,482,-212,51,774,789
4848,645,824,179,14,165,180
4849,511,65,-446,37,540,555
4850,213,974,761,50,747,762
4851,695,494,-201,54,785,800
4852,830,443,-387,41,599,614
4853,981,258,-723,20,263,278
4854,251,547,296,20,282,297
4855,417,241,-176,53,810,825
4856,773,444,-329,46,657,672
4857,223,536,313,22,299,314
4858,526,135,-391,40,595,610
4859,90,259,169,13,155,170
4860,212,724,512,33,498,513
4861,857,412,-445,38,541,556
4862,390,544,154,12,140,155
4863,660,709,49,5,35,50
4864,820,811,-9,66,977,992
4865,978,247,-731,20,255,270
4866,121,629,508,34,494,509
4867,435,321,-114,58,872,887
4868,146,636,490,33,476,491
4869,977,27,-950,5,36,51
4870,648,218,-430,38,556,571
4871,939,12,-927,7,59,74
4872,619,936,317,23,303,318
4873,314,125,-189,54,797,812
4874,981,533,-448,36,538,553
4875,618,332,-286,47,700,715
4876,831,569,-262,48,724,739
4877,569,772,203,16,189,204
4878,675,129,-546,31,440,455
4879,844,677,-167,54,819,834
4880,330,138,-192,52,794,809
4881,717,875,158,13,144,159
4882,883,709,-174,54,812,827
4883,559,438,-121,59,865,880
4884,882,511,-371,42,615,630
4885,827,211,-616,25,370,385
4886,472,389,-83,60,903,918
4887,317,665,348,24,334,349
4888,479,966,487,34,473,488
4889,737,700,-37,63,949,964
4890,257,802,545,36,531,546
4891,682,41,-641,26,345,360
4892,102,239,137,11,123,138
4893,434,795,361,25,347,362
4894,231,601,370,25,356,371
4895,376,265,-111,58,875,890
4896,61,101,40,4,26,41
4897,427,711,284,20,270,285
4898,936,456,-480,34,506,521
4899,603,509,-94,59,892,907
4900,31,827,796,52,782,797
4901,444,330,-114,58,872,887
4902,233,36,-197,53,789,804
4903,449,468,19,4,5,20
4904,849,493,-356,42,630,645
4905,480,397,-83,60,903,918
4906,958,583,-375,41,611,626
4907,955,774,-181,54,805,820
4908,780,736,-44,62,942,957
4909,503,457,-46,62,940,955
4910,761,100,-661,24,325,340
4911,463,549,86,8,72,87
4912,150,708,558,38,544,559
4913,830,752,-78,60,908,923
4914,611,939,328,22,314,329
4915,115,688,573,39,559,574
4916,120,987,867,57,853,868
4917,862,995,133,11,119,134
4918,508,303,-205,53,781,796
4919,193,699,506,34,492,507
4920,965,923,-42,63,944,959
4921,894,115,-779,17,207,222
4922,499,377,-122,58,864,879
4923,628,759,131,11,117,132
4924,622,784,162,12,148,163
4925,791,563,-228,50,758,773
4926,914,4,-910,8,76,91
4927,579,935,356,24,342,357
4928,995,832,-163,55,823,838
4929,966,874,-92,59,894,909
4930,564,149,-415,39,571,586
4931,851,813,-38,62,948,963
4932,815,575,-240,49,746,761
4933,610,174,-436,37,550,565
4934,659,798,139,12,125,140
4935,543,89,-454,36,532,547
4936,141,756,615,42,601,616
4937,961,920,-41,64,945,960
4938,319,683,364,25,350,365
4939,151,120,-31,63,955,970
4940,563,628,65,6,51,66
4941,152,323,171,14,157,172
4942,381,921,540,36,526,541
4943,194,751,557,38,543,558
4944,141,416,275,20,261,276
4945,910,669,-241,51,745,760
4946,3,285,282,20,268,283
4947,68,95,27,5,13,28
4948,446,838,392,26,378,393
4949,786,373,-413,40,573,588
4950,21,13,-8,63,978,993
4951,809,568,-241,51,745,760
4952,855,181,-674,23,312,327
4953,309,919,610,40,596,611
4954,381,631,250,18,236,251
4955,986,527,-459,37,527,542
4956,345,916,571,39,557,572
4957,659,777,118,10,104,119
4958,203,67,-136,55,850,865
4959,762,475,-287,47,699,714
4960,246,907,661,44,647,662
4961,513,620,107,10,93,108
4962,193,508,315,23,301,316
4963,428,453,25,4,11,26
4964,230,642,412,28,398,413
4965,665,133,-532,31,454,469
4966,292,412,120,9,106,121
4967,83,611,528,34,514,529
4968,514,315,-199,52,787,802
4969,136,830,694,46,680,695
4970,402,882,480,31,466,481
4971,998,73,-925,8,61,76
4972,117,752,635,43,621,636
4973,57,902,845,56,831,846
4974,392,521,129,10,115,130
4975,974,70,-904,7,82,97
4976,760,453,-307,46,679,694
4977,496,795,299,22,285,300
4978,729,282,-447,37,539,554
4979,916,190,-726,19,260,275
4980,316,123,-193,54,793,808
4981,16,110,94,9,80,95
4982,106,676,570,38,556,571
4983,72,810,738,48,724,739
4984,531,857,326,23,312,327
4985,998,49,-949,6,37,52
4986,144,534,390,27,376,391
4987,318,426,108,9,94,109
4988,882,814,-68,60,918,933
4989,997,617,-380,41,606,621
4990,780,347,-433,39,553,568
4991,187,385,198,15,184,199
4992,356,669,313,22,299,314
4993,251,917,666,44,652,667
4994,311,36,-275,48,711,726
4995,437,150,-287,47,699,714
4996,372,541,169,13,155,170
4997,268,481,213,16,199,214
4998,874,82,-792,14,194,209
4999,407,309,-98,59,888,903
5000,699,103,-596,27,390,405
5001,531,915,384,25,370,385
5002,656,24,-632,24,354,369
5003,544,863,319,24,305,320
5004,28,479,451,31,437,452
5005,859,200,-659,24,327,342
5006,362,876,514,34,500,515
5007,689,912,223,18,209,224
5008,271,355,84,7,70,85
5009,621,716,95,10,81,96
5010,265,961,696,45,682,697
5011,400,365,-35,63,951,966
5012,677,631,-46,62,940,955
5013,359,157,-202,53,784,799
5014,657,838,181,14,167,182
5015,166,437,271,21,257,272
5016,148,751,603,41,589,604
5017,101,529,428,29,414,429
5018,583,168,-415,39,571,586
5019,26,353,327,24,313,328
5020,603,499,-104,57,882,897
5021,264,932,668,44,654,669
5022,790,39,-751,18,235,250
5023,616,306,-310,45,676,691
5024,750,217,-533,32,453,468
5025,538,306,-232,49,754,769
5026,361,404,43,6,29,44
5027,159,934,775,52,761,776
5028,828,623,-205,53,781,796
5029,417,212,-205,53,781,796
5030,2,774,772,50,758,773
5031,844,280,-564,29,422,437
5032,6,874,868,56,854,869
5033,70,167,97,8,83,98
5034,986,791,-195,53,791,806
5035,863,347,-516,32,470,485
5036,869,592,-277,48,709,724
5037,399,83,-316,45,670,685
5038,242,677,435,30,421,436
5039,548,569,21,4,7,22
5040,193,28,-165,55,821,836
5041,850,220,-630,25,356,371
5042,480,577,97,8,83,98
5043,146,554,408,27,394,409
5044,529,474,-55,61,931,946
5045,57,461,404,27,390,405
5046,247,60,-187,54,799,814
5047,59,114,55,7,41,56
5048,521,927,406,28,392,407
5049,98,946,848,54,834,849
5050,932,83,-849,13,137,152
5051,578,345,-233,52,753,768
5052,372,319,-53,62,933,948
5053,13,583,570,38,556,571
5054,761,218,-543,31,443,458
5055,911,386,-525,33,461,476
5056,981,842,-139,57,847,862
5057,4,886,882,57,868,883
5058,74,442,368,24,354,369
5059,651,214,-437,38,549,564
5060,668,26,-642,25,344,359
5061,55,994,939,62,925,940
5062,180,138,-42,63,944,959
5063,986,864,-122,58,864,879
5064,921,605,-316,45,670,685
5065,492,801,309,22,295,310
5066,295,558,263,20,249,264
5067,747,523,-224,50,762,777
5068,127,849,722,47,708,723
5069,417,95,-322,45,664,679
5070,484,202,-282,48,704,719
5071,259,9,-250,50,736,751
5072,513,115,-398,40,588,603
5073,266,97,-169,56,817,832
5074,502,674,172,13,158,173
5075,491,304,-187,54,799,814
5076,999,815,-184,52,802,817
5077,980,660,-320,44,666,681
5078,871,834,-37,63,949,964
5079,333,944,611,41,597,612
5080,370,634,264,18,250,265
5081,733,101,-632,24,354,369
5082,560,675,115,10,101,116
5083,162,845,683,46,669,684
5084,695,378,-317,46,669,684
5085,269,852,583,40,569,584
5086,634,203,-431,38,555,570
5087,392,954,562,37,548,563
5088,364,543,179,14,165,180
5089,275,168,-107,59,879,894
5090,635,356,-279,47,707,722
5091,337,388,51,6,37,52
5092,546,213,-333,45,653,668
5093,621,322,-299,47,687,702
5094,658,79,-579,29,407,422
5095,344,714,370,25,356,371
5096,161,142,-19,64,967,982
5097,944,391,-553,32,433,448
5098,111,19,-92,59,894,909
5099,32,393,361,25,347,362
5100,853,244,-609,28,377,392
5101,708,157,-551,30,435,450
5102,756,178,-578,29,408,423
5103,643,177,-466,36,520,535
5104,269,951,682,45,668,683
5105,439,459,20,3,6,21
5106,173,194,21,4,7,22
5107,251,185,-66,61,920,935
5108,710,738,28,4,14,29
5109,699,748,49,5,35,50
5110,703,43,-660,23,326,341
5111,860,435,-425,40,561,576
5112,121,76,-45,63,941,956
5113,138,319,181,14,167,182
5114,464,68,-396,40,590,605
5115,168,998,830,55,816,831
5116,134,184,50,5,36,51
5117,264,163,-101,59,885,900
5118,276,414,138,11,124,139
5119,218,81,-137,58,849,864
5120,752,878,126,11,112,127
5121,583,296,-287,47,699,714
5122,549,692,143,13,129,144
5123,703,85,-618,27,368,383
5124,686,169,-517,33,469,484
5125,220,918,698,46,684,699
5126,314,385,71,8,57,72
5127,513,645,132,10,118,133
5128,451,655,204,15,190,205
5129,737,246,-491,35,495,510
5130,913,856,-57,63,929,944
5131,782,566,-216,50,770,785
5132,523,253,-270,48,716,731
5133,840,987,147,12,133,148
5134,115,290,175,15,161,176
5135,381,4,-377,43,609,624
5136,699,142,-557,31,429,444
5137,19,280,261,19,247,262
5138,236,550,314,22,300,315
5139,869,594,-275,48,711,726
5140,560,153,-407,39,579,594
5141,828,928,100,8,86,101
5142,361,382,21,4,7,22
5143,5,657,652,43,638,653
5144,511,320,-191,53,795,810
5145,948,14,-934,6,52,67
5146,266,141,-125,58,861,876
5147,483,342,-141,57,845,860
5148,529,83,-446,37,540,555
5149,568,495,-73,62,913,928
5150,674,795,121,10,107,122
5151,989,804,-185,55,801,816
5152,896,906,10,3,4,11
5153,524,748,224,15,210,225
5154,472,974,502,34,488,503
5155,633,435,-198,52,788,803
5156,432,982,550,37,536,551
5157,154,703,549,37,535,550
5158,967,419,-548,30,438,453
5159,235,465,230,17,216,231
5160,461,593,132,10,118,133
5161,320,601,281,20,267,282
5162,196,941,745,49,731,746
5163,171,748,577,38,563,578
5164,148,616,468,31,454,469
5165,762,766,4,2,2,5
5166,432,124,-308,45,678,693
5167,672,6,-666,24,320,335
5168,932,406,-526,32,460,475
5169,775,458,-317,46,669,684
5170,284,436,152,11,138,153
5171,724,170,-554,31,432,447
5172,97,917,820,53,806,821
5173,518,471,-47,62,939,954
5174,975,478,-497,35,489,504
5175,132,428,296,20,282,297
5176,823,957,134,11,120,135
5177,304,751,447,32,433,448
5178,141,616,475,33,461,476
5179,581,757,176,12,162,177
5180,872,381,-491,35,495,510
5181,272,844,572,38,558,573
5182,907,146,-761,19,225,240
5183,303,752,449,30,435,450
5184,776,576,-200,51,786,801
5185,319,824,505,34,491,506
5186,316,353,37,5,23,38
5187,808,530,-278,47,708,723
5188,253,526,273,19,259,274
5189,480,134,-346,44,640,655
5190,547,671,124,10,110,125
5191,619,102,-517,33,469,484
5192,237,332,95,10,81,96
5193,78,340,262,19,248,263
5194,912,178,-734,19,252,267
5195,824,160,-664,22,322,337
5196,36,430,394,27,380,395
5197,281,507,226,16,212,227
5198,744,500,-244,49,742,757
5199,524,637,113,9,99,114
5200,634,639,5,3,3,6
5201,632,664,32,3,18,33
5202,484,976,492,33,478,493
5203,136,814,678,45,664,679
5204,885,129,-756,17,230,245
5205,457,875,418,28,404,419
5206,512,654,142,12,128,143
5207,574,308,-266,49,720,735
5208,946,627,-319,45,667,682
5209,139,666,527,37,513,528
5210,444,719,275,20,261,276
5211,600,95,-505,35,481,496
5212,327,382,55,7,41,56
5213,204,341,137,11,123,138
5214,37,31,-6,64,980,995
5215,836,667,-169,56,817,832
5216,44,296,252,18,238,253
5217,272,16,-256,48,730,745
5218,802,627,-175,54,811,826
5219,190,13,-177,55,809,824
5220,410,563,153,12,139,154
5221,986,994,8,2,2,9
5222,93,27,-66,61,920,935
5223,483,821,338,23,324,339
5224,144,434,290,20,276,291
5225,870,660,-210,52,776,791
5226,812,349,-463,36,523,538
5227,877,55,-822,13,164,179
5228,677,137,-540,31,446,461
5229,411,511,100,8,86,101
5230,264,907,643,43,629,644
5231,191,187,-4,64,982,997
5232,621,900,279,21,265,280
5233,664,163,-501,34,485,500
5234,523,328,-195,53,791,806
5235,397,794,397,28,383,398
5236,28,131,103,10,89,104
5237,496,678,182,14,168,183
5238,880,369,-511,33,475,490
5239,701,15,-686,22,300,315
5240,605,492,-113,59,873,888
5241,535,246,-289,48,697,712
5242,238,694,456,30,442,457
5243,546,702,156,12,142,157
5244,940,208,-732,19,254,269
5245,746,200,-546,31,440,455
5246,998,53,-945,7,41,56
5247,442,146,-296,45,690,705
5248,662,955,293,21,279,294
5249,683,869,186,14,172,187
5250,873,559,-314,46,672,687
5251,303,744,441,30,427,442
5252,882,39,-843,13,143,158
5253,785,975,190,15,176,191
5254,179,571,392,26,378,393
5255,876,188,-688,21,298,313
5256,512,55,-457,38,529,544
5257,915,750,-165,55,821,836
5258,934,768,-166,54,820,835
5259,791,549,-242,50,744,759
5260,837,959,122,10,108,123
5261,516,466,-50,62,936,951
5262,395,500,105,9,91,106
5263,859,493,-366,42,620,635
5264,933,954,21,4,7,22
5265,308,134,-174,54,812,827
5266,359,703,344,23,330,345
5267,770,700,-70,60,916,931
5268,517,960,443,31,429,444
5269,272,100,-172,54,814,829
5270,525,560,35,5,21,36
5271,64,475,411,29,397,412
5272,219,150,-69,61,917,932
5273,39,437,398,28,384,399
5274,450,138,-312,44,674,689
5275,650,328,-322,45,664,679
5276,238,710,472,31,458,473
5277,311,302,-9,66,977,992
5278,44,269,225,16,211,226
5279,275,420,145,11,131,146
5280,537,317,-220,51,766,781
5281,631,790,159,14,145,160
5282,674,825,151,13,137,152
5283,828,17,-811,15,175,190
5284,382,84,-298,47,688,703
5285,300,475,175,15,161,176
5286,425,513,88,7,74,89
5287,109,189,80,6,66,81
5288,609,516,-93,60,893,908
5289,744,636,-108,58,878,893
5290,806,413,-393,42,593,608
5291,560,971,411,29,397,412
5292,567,112,-455,36,531,546
5293,15,388,373,26,359,374
5294,270,815,545,36,531,546
5295,857,82,-775,16,211,226
5296,702,743,41,5,27,42
5297,226,468,242,17,228,243
5298,253,642,389,27,375,390
5299,535,594,59,7,45,60
5300,114,582,468,31,454,469
5301,14,661,647,44,633,648
5302,660,200,-460,36,526,541
5303,182,182,0,1,1,1
5304,351,773,422,29,408,423
5305,166,285,119,11,105,120
5306,515,514,-1,66,985,1000
5307,998,914,-84,59,902,917
5308,518,592,74,7,60,75
5309,727,619,-108,58,878,893
5310,621,898,277,20,263,278
5311,368,241,-127,57,859,874
5312,325,451,126,11,112,127
5313,212,377,165,13,151,166
5314,109,461,352,23,338,353
5315,454,735,281,20,267,282
5316,139,273,134,11,120,135
5317,849,728,-121,59,865,880
5318,118,671,553,37,539,554
5319,903,881,-22,63,964,979
5320,649,594,-55,61,931,946
5321,223,584,361,25,347,362
5322,10,340,330,23,316,331
5323,982,835,-147,56,839,854
5324,249,142,-107,59,879,894
5325,465,35,-430,38,556,571
5326,243,751,508,34,494,509
5327,285,591,306,21,292,307
5328,764,837,73,7,59,74
5329,699,275,-424,37,562,577
5330,357,595,238,18,224,239
5331,328,162,-166,54,820,835
5332,563,197,-366,42,620,635
5333,859,22,-837,13,149,164
5334,90,805,715,48,701,716
5335,306,414,108,9,94,109
5336,678,144,-534,31,452,467
5337,81,198,117,10,103,118
5338,311,242,-69,61,917,932
5339,589,112,-477,36,509,524
5340,579,841,262,19,248,263
5341,362,845,483,33,469,484
5342,747,229,-518,32,468,483
5343,204,925,721,47,707,722
5344,839,510,-329,46,657,672
5345,838,386,-452,36,534,549
5346,317,824,507,35,493,508
5347,453,219,-234,51,752,767
5348,113,156,43,6,29,44
5349,919,858,-61,62,925,940
5350,173,67,-106,59,880,895
5351,402,497,95,10,81,96
5352,580,182,-398,40,588,603
5353,339,683,344,23,330,345
5354,797,212,-585,30,401,416
5355,350,916,566,38,552,567
5356,882,219,-663,23,323,338
5357,208,452,244,17,230,245
5358,703,84,-619,27,367,382
5359,625,777,152,11,138,153
5360,789,557,-232,49,754,769
5361,112,114,2,2,2,3
5362,775,299,-476,35,510,525
5363,960,691,-269,49,717,732
5364,179,265,86,8,72,87
5365,486,823,337,23,323,338
5366,160,171,11,4,5,12
5367,943,937,-6,64,980,995
5368,187,433,246,18,232,247
5369,432,461,29,5,15,30
5370,219,915,696,45,682,697
5371,917,552,-365,43,621,636
5372,19,774,755,50,741,756
5373,620,117,-503,33,483,498
5374,948,224,-724,19,262,277
5375,508,626,118,10,104,119
5376,720,51,-669,24,317,332
5377,422,932,510,35,496,511
5378,640,314,-326,44,660,675
5379,11,613,602,40,588,603
5380,963,981,18,3,4,19
5381,376,446,70,7,56,71
5382,275,169,-106,59,880,895
5383,657,480,-177,55,809,824
5384,430,70,-360,41,626,641
5385,473,142,-331,45,655,670
5386,110,874,764,50,750,765
5387,196,598,402,27,388,403
5388,717,639,-78,60,908,923
5389,464,167,-297,48,689,704
5390,805,95,-710,20,276,291
5391,269,899,630,42,616,631
5392,676,792,116,9,102,117
5393,176,601,425,29,411,426
5394,515,610,95,10,81,96
5395,257,832,575,40,561,576
5396,939,186,-753,19,233,248
5397,324,332,8,2,2,9
5398,208,384,176,12,162,177
5399,365,906,541,37,527,542
5400,288,237,-51,62,935,950
5401,216,544,328,22,314,329
5402,717,367,-350,43,636,651
5403,671,25,-646,24,340,355
5404,166,909,743,50,729,744
5405,553,422,-131,57,855,870
5406,298,847,549,37,535,550
5407,608,585,-23,63,963,978
5408,845,135,-710,20,276,291
5409,244,673,429,30,415,430
5410,877,254,-623,26,363,378
5411,0,877,877,58,863,878
5412,96,813,717,48,703,718
5413,638,522,-116,57,870,885
5414,709,10,-699,22,287,302
5415,722,534,-188,53,798,813
5416,795,119,-676,22,310,325
5417,426,412,-14,64,972,987
5418,461,712,251,19,237,252
5419,126,84,-42,63,944,959
5420,416,263,-153,57,833,848
5421,186,383,197,15,183,198
5422,122,172,50,5,36,51
5423,791,329,-462,36,524,539
5424,881,674,-207,52,779,794
5425,406,211,-195,53,791,806
5426,425,906,481,32,467,482
5427,842,720,-122,58,864,879
5428,531,552,21,4,7,22
5429,83,57,-26,64,960,975
5430,285,405,120,9,106,121
5431,696,578,-118,57,868,883
5432,828,957,129,10,115,130
5433,411,311,-100,58,886,901
5434,743,313,-430,38,556,571
5435,966,54,-912,7,74,89
5436,986,886,-100,58,886,901
5437,558,533,-25,65,961,976
5438,445,282,-163,55,823,838
5439,923,217,-706,21,280,295
5440,837,498,-339,44,647,662
5441,979,688,-291,47,695,710
5442,533,195,-338,44,648,663
5443,117,793,676,44,662,677
5444,436,773,337,23,323,338
5445,644,290,-354,43,632,647
5446,893,435,-458,37,528,543
5447,84,999,915,60,901,916
5448,327,497,170,13,156,171
5449,655,478,-177,55,809,824
5450,874,77,-797,16,189,204
5451,8,522,514,34,500,515
5452,841,358,-483,35,503,518
5453,372,770,398,28,384,399
5454,443,589,146,11,132,147
5455,746,519,-227,51,759,774
5456,413,816,403,28,389,404
5457,518,839,321,22,307,322
5458,455,122,-333,45,653,668
5459,606,566,-40,61,946,961
5460,661,888,227,17,213,228
5461,50,877,827,55,813,828
5462,363,249,-114,58,872,887
5463,818,77,-741,19,245,260
5464,155,842,687,47,673,688
5465,205,73,-132,56,854,869
5466,196,615,419,29,405,420
5467,160,946,786,51,772,787
5468,694,616,-78,60,908,923
5469,124,860,736,47,722,737
5470,531,763,232,16,218,233
5471,877,795,-82,60,904,919
5472,104,597,493,34,479,494
5473,626,557,-69,61,917,932
5474,785,243,-542,31,444,459
5475,294,316,22,4,8,23
5476,285,231,-54,61,932,947
5477,813,65,-748,18,238,253
5478,866,744,-122,58,864,879
5479,525,581,56,5,42,57
5480,481,74,-407,39,579,594
5481,498,145,-353,44,633,648
5482,196,120,-76,60,910,925
5483,830,881,51,6,37,52
5484,725,244,-481,36,505,520
5485,880,318,-562,30,424,439
5486,588,323,-265,50,721,736
5487,305,471,166,13,152,167
5488,671,410,-261,49,725,740
5489,532,311,-221,52,765,780
5490,116,957,841,55,827,842
5491,218,827,609,40,595,610
5492,301,850,549,37,535,550
5493,96,705,609,40,595,610
5494,513,358,-155,56,831,846
5495,998,465,-533,32,453,468
5496,171,319,148,11,134,149
5497,455,307,-148,55,838,853
5498,307,311,4,2,2,5
5499,598,398,-200,51,786,801
5500,218,399,181,14,167,182
5501,717,23,-694,21,292,307
5502,602,882,280,19,266,281
5503,277,827,550,37,536,551
5504,295,560,265,19,251,266
5505,752,842,90,8,76,91
5506,661,350,-311,45,675,690
5507,264,461,197,15,183,198
5508,727,274,-453,37,533,548
5509,130,522,392,26,378,393
5510,917,541,-376,40,610,625
5511,566,448,-118,57,868,883
5512,793,452,-341,44,645,660
5513,488,108,-380,41,606,621
5514,746,544,-202,53,784,799
5515,174,711,537,36,523,538
5516,790,556,-234,51,752,767
5517,280,452,172,13,158,173
5518,15,708,693,46,679,694
5519,604,535,-69,61,917,932
5520,830,575,-255,49,731,746
5521,239,55,-184,52,802,817
5522,236,201,-35,63,951,966
5523,361,468,107,10,93,108
5524,103,534,431,31,417,432
5525,616,992,376,25,362,377
5526,533,580,47,7,33,48
5527,728,521,-207,52,779,794
5528,504,883,379,27,365,380
5529,152,217,65,6,51,66
5530,92,982,890,58,876,891
5531,652,159,-493,35,493,508
5532,467,78,-389,41,597,612
5533,530,457,-73,62,913,928
5534,62,929,867,57,853,868
5535,779,987,208,14,194,209
5536,192,537,345,24,331,346
5537,310,924,614,41,600,615
5538,487,772,285,21,271,286
5539,654,882,228,16,214,229
5540,722,520,-202,53,784,799
5541,371,373,2,2,2,3
5542,511,961,450,30,436,451
5543,193,439,246,18,232,247
5544,874,898,24,3,10,25
5545,211,412,201,15,187,202
5546,192,339,147,12,133,148
5547,678,799,121,10,107,122
5548,711,185,-526,32,460,475
5549,204,552,348,24,334,349
5550,828,315,-513,34,473,488
5551,993,502,-491,35,495,510
5552,294,622,328,22,314,329
5553,548,729,181,14,167,182
5554,863,717,-146,56,840,855
5555,447,810,363,26,349,364
5556,422,99,-323,45,663,678
5557,811,87,-724,19,262,277
5558,602,316,-286,47,700,715
5559,6,70,64,5,50,65
5560,695,880,185,14,171,186
5561,512,425,-87,59,899,914
5562,490,218,-272,47,714,729
5563,782,854,72,6,58,73
5564,227,575,348,24,334,349
5565,645,956,311,23,297,312
5566,263,833,570,38,556,571
5567,875,775,-100,58,886,901
5568,151,236,85,8,71,86
5569,605,15,-590,28,396,411
5570,40,663,623,43,609,624
5571,413,905,492,33,478,493
5572,94,61,-33,64,953,968
5573,231,878,647,44,633,648
5574,359,706,347,25,333,348
5575,196,147,-49,63,937,952
5576,99,395,296,20,282,297
5577,938,881,-57,63,929,944
5578,189,347,158,13,144,159
5579,242,888,646,43,632,647
5580,978,307,-671,23,315,330
5581,822,380,-442,38,544,559
5582,575,59,-516,32,470,485
5583,485,307,-178,54,808,823
5584,124,209,85,8,71,86
5585,8,111,103,10,89,104
5586,170,428,258,18,244,259
5587,79,571,492,33,478,493
5588,800,147,-653,25,333,348
5589,643,960,317,23,303,318
5590,19,709,690,45,676,691
5591,143,961,818,53,804,819
5592,113,270,157,13,143,158
5593,486,433,-53,62,933,948
5594,538,347,-191,53,795,810
5595,423,249,-174,54,812,827
5596,617,963,346,24,332,347
5597,855,461,-394,41,592,607
5598,239,315,76,7,62,77
5599,854,544,-310,45,676,691
5600,553,239,-314,46,672,687
5601,627,11,-616,25,370,385
5602,51,554,503,35,489,504
5603,625,883,258,18,244,259
5604,531,115,-416,38,570,585
5605,923,134,-789,16,197,212
5606,680,620,-60,61,926,941
5607,49,657,608,39,594,609
5608,381,544,163,13,149,164
5609,889,905,16,2,2,17
5610,616,774,158,13,144,159
5611,280,392,112,8,98,113
5612,833,429,-404,39,582,597
5613,344,185,-159,55,827,842
5614,159,220,61,7,47,62
5615,863,873,10,3,4,11
5616,965,659,-306,46,680,695
5617,44,8,-36,62,950,965
5618,24,527,503,35,489,504
5619,712,789,77,8,63,78
5620,663,864,201,15,187,202
5621,307,924,617,41,603,618
5622,810,858,48,4,34,49
5623,251,613,362,25,348,363
5624,427,887,460,31,446,461
5625,908,783,-125,58,861,876
5626,811,210,-601,29,385,400
5627,679,657,-22,63,964,979
5628,384,329,-55,61,931,946
5629,760,256,-504,32,482,497
5630,495,690,195,15,181,196
5631,147,903,756,49,742,757
5632,622,540,-82,60,904,919
5633,529,243,-286,47,700,715
5634,203,993,790,52,776,791
5635,537,890,353,24,339,354
5636,360,618,258,18,244,259
5637,577,16,-561,31,425,440
5638,95,325,230,17,216,231
5639,542,56,-486,34,500,515
5640,439,679,240,16,226,241
5641,449,25,-424,37,562,577
5642,185,633,448,29,434,449
5643,893,254,-639,25,347,362
5644,958,447,-511,33,475,490
5645,854,506,-348,43,638,653
5646,411,760,349,25,335,350
5647,522,998,476,32,462,477
5648,472,669,197,15,183,198
5649,430,830,400,26,386,401
5650,782,814,32,3,18,33
5651,524,885,361,25,347,362
5652,543,99,-444,37,542,557
5653,968,745,-223,51,763,778
5654,901,837,-64,60,922,937
5655,240,522,282,20,268,283
5656,491,190,-301,47,685,700
5657,845,901,56,5,42,57
5658,703,601,-102,58,884,899
5659,715,711,-4,64,982,997
5660,676,210,-466,36,520,535
5661,16,307,291,21,277,292
5662,356,768,412,28,398,413
5663,536,527,-9,66,977,992
5664,521,263,-258,49,728,743
5665,32,194,162,12,148,163
5666,876,343,-533,32,453,468
5667,607,524,-83,60,903,918
5668,711,858,147,12,133,148
5669,923,883,-40,61,946,961
5670,411,917,506,34,492,507
5671,855,181,-674,23,312,327
5672,707,698,-9,66,977,992
5673,70,528,458,31,444,459
5674,746,678,-68,60,918,933
5675,109,257,148,11,134,149
5676,357,787,430,30,416,431
5677,911,291,-620,26,366,381
5678,711,385,-326,44,660,675
5679,305,872,567,39,553,568
5680,520,893,373,26,359,374
5681,344,192,-152,54,834,849
5682,770,286,-484,34,502,517
5683,734,17,-717,21,269,284
5684,87,527,440,29,426,441
5685,925,982,57,6,43,58
5686,867,592,-275,48,711,726
5687,198,319,121,10,107,122
5688,658,817,159,14,145,160
5689,691,106,-585,30,401,416
5690,939,159,-780,16,206,221
5691,392,789,397,28,383,398
5692,716,545,-171,55,815,830
5693,620,618,-2,65,984,999
5694,992,117,-875,11,111,126
5695,9,139,130,10,116,131
5696,855,690,-165,55,821,836
5697,35,632,597,40,583,598
5698,737,201,-536,30,450,465
5699,361,157,-204,52,782,797
5700,697,513,-184,52,802,817
5701,315,840,525,36,511,526
5702,328,889,561,37,547,562
5703,248,608,360,24,346,361
5704,707,931,224,15,210,225
5705,152,368,216,15,202,217
5706,671,468,-203,53,783,798
5707,151,462,311,23,297,312
5708,731,788,57,6,43,58
5709,941,223,-718,20,268,283
5710,296,782,486,33,472,487
5711,55,681,626,41,612,627
5712,546,622,76,7,62,77
5713,269,348,79,9,65,80
5714,779,920,141,12,127,142
5715,100,959,859,57,845,860
5716,901,457,-444,37,542,557
5717,5,199,194,14,180,195
5718,502,375,-127,57,859,874
5719,210,965,755,50,741,756
5720,305,306,1,2,2,2
5721,889,412,-477,36,509,524
5722,596,970,374,26,360,375
5723,797,339,-458,37,528,543
5724,553,982,429,30,415,430
5725,167,649,482,32,468,483
5726,477,409,-68,60,918,933
5727,524,367,-157,56,829,844
5728,848,267,-581,29,405,420
5729,448,563,115,10,101,116
5730,434,625,191,16,177,192
5731,227,240,13,4,7,14
5732,734,277,-457,38,529,544
5733,834,815,-19,64,967,982
5734,519,199,-320,44,666,681
5735,205,843,638,43,624,639
5736,583,962,379,27,365,380
5737,247,23,-224,50,762,777
5738,93,586,493,34,479,494
5739,213,661,448,29,434,449
5740,783,74,-709,21,277,292
5741,39,795,756,49,742,757
5742,872,82,-790,15,196,211
5743,723,507,-216,50,770,785
5744,858,653,-205,53,781,796
5745,371,272,-99,59,887,902
5746,312,13,-299,47,687,702
5747,961,363,-598,27,388,403
5748,325,500,175,15,161,176
5749,435,745,310,22,296,311
5750,526,935,409,28,395,410
5751,977,302,-675,23,311,326
5752,619,503,-116,57,870,885
5753,336,930,594,39,580,595
5754,341,745,404,27,390,405
5755,770,171,-599,27,387,402
5756,481,800,319,24,305,320
5757,270,394,124,10,110,125
5758,15,278,263,20,249,264
5759,255,61,-194,53,792,807
5760,646,942,296,20,282,297
5761,846,38,-808,13,178,193
5762,589,7,-582,28,404,419
5763,815,824,9,3,3,10
5764,58,308,250,18,236,251
5765,571,776,205,16,191,206
5766,746,377,-369,43,617,632
5767,544,150,-394,41,592,607
5768,891,354,-537,33,449,464
5769,248,800,552,36,538,553
5770,112,824,712,46,698,713
5771,632,551,-81,61,905,920
5772,313,300,-13,65,973,988
5773,901,613,-288,46,698,713
5774,963,221,-742,18,244,259
5775,775,966,191,16,177,192
5776,843,870,27,5,13,28
5777,432,547,115,10,101,116
5778,122,942,820,53,806,821
5779,48,69,21,4,7,22
5780,445,287,-158,55,828,843
5781,507,617,110,10,96,111
5782,261,968,707,47,693,708
5783,217,202,-15,64,971,986
5784,781,590,-191,53,795,810
5785,439,957,518,35,504,519
5786,372,962,590,40,576,591
5787,219,789,570,38,556,571
5788,840,189,-651,25,335,350
5789,8,103,95,10,81,96
5790,917,99,-818,14,168,183
5791,823,134,-689,23,297,312
5792,216,664,448,29,434,449
5793,848,939,91,9,77,92
5794,480,421,-59,62,927,942
5795,984,69,-915,8,71,86
5796,161,190,29,5,15,30
5797,658,398,-260,48,726,741
5798,738,657,-81,61,905,920
5799,245,834,589,40,575,590
5800,432,617,185,14,171,186
5801,252,882,630,42,616,631
5802,959,370,-589,29,397,412
5803,217,648,431,31,417,432
5804,657,981,324,22,310,325
5805,591,912,321,22,307,322
5806,286,295,9,3,3,10
5807,32,81,49,5,35,50
5808,146,241,95,10,81,96
5809,186,435,249,18,235,250
5810,115,723,608,39,594,609
5811,287,283,-4,64,982,997
5812,635,103,-532,31,454,469
5813,972,728,-244,49,742,757
5814,937,990,53,6,39,54
5815,557,366,-191,53,795,810
5816,559,580,21,4,7,22
5817,200,688,488,32,474,489
5818,847,520,-327,44,659,674
5819,977,918,-59,62,927,942
5820,54,102,48,4,34,49
5821,891,503,-388,40,598,613
5822,660,195,-465,37,521,536
5823,147,471,324,22,310,325
5824,273,276,3,3,3,4
5825,774,428,-346,44,640,655
5826,903,27,-876,10,110,125
5827,355,846,491,34,477,492
5828,512,827,315,23,301,316
5829,454,559,105,9,91,106
5830,842,968,126,11,112,127
5831,642,910,268,19,254,269
5832,457,958,501,34,487,502
5833,274,429,155,13,141,156
5834,708,4,-704,20,282,297
5835,482,531,49,5,35,50
5836,346,793,447,32,433,448
5837,367,175,-192,52,794,809
5838,712,374,-338,44,648,663
5839,656,833,177,13,163,178
5840,536,490,-46,62,940,955
5841,98,683,585,39,571,586
5842,333,959,626,41,612,627
5843,693,738,45,6,31,46
5844,438,938,500,33,486,501
5845,3,531,528,34,514,529
5846,425,715,290,20,276,291
5847,971,790,-181,54,805,820
5848,688,315,-373,42,613,628
5849,163,532,369,25,355,370
5850,151,929,778,51,764,779
5851,584,462,-122,58,864,879
5852,932,637,-295,46,691,706
5853,710,158,-552,29,434,449
5854,8,888,880,56,866,881
5855,797,620,-177,55,809,824
5856,53,88,35,5,21,36
5857,152,177,25,4,11,26
5858,165,765,600,39,586,601
5859,644,13,-631,25,355,370
5860,23,300,277,20,263,278
5861,106,872,766,51,752,767
5862,248,576,328,22,314,329
5863,2,12,10,3,4,11
5864,634,880,246,18,232,247
5865,762,320,-442,38,544,559
5866,287,289,2,2,2,3
5867,91,938,847,57,833,848
5868,419,537,118,10,104,119
5869,517,44,-473,37,513,528
5870,778,87,-691,22,295,310
5871,9,794,785,51,771,786
5872,978,808,-170,55,816,831
5873,952,251,-701,22,285,300
5874,718,191,-527,32,459,474
5875,18,22,4,2,2,5
5876,492,749,257,18,243,258
5877,238,627,389,27,375,390
5878,251,700,449,30,435,450
5879,202,446,244,17,230,245
5880,58,189,131,11,117,132
5881,133,472,339,24,325,340
5882,495,584,89,8,75,90
5883,958,275,-683,23,303,318
5884,381,897,516,34,502,517
5885,574,583,9,3,3,10
5886,811,70,-741,19,245,260
5887,150,984,834,54,820,835
5888,405,71,-334,44,652,667
5889,719,852,133,11,119,134
5890,88,130,42,5,28,43
5891,992,219,-773,17,213,228
5892,550,751,201,15,187,202
5893,898,448,-450,37,536,551
5894,980,428,-552,29,434,449
5895,340,529,189,15,175,190
5896,693,548,-145,57,841,856
5897,143,51,-92,59,894,909
5898,832,162,-670,23,316,331
5899,174,360,186,14,172,187
5900,798,879,81,7,67,82
5901,896,809,-87,59,899,914
5902,572,705,133,11,119,134
5903,567,155,-412,39,574,589
5904,230,424,194,14,180,195
5905,155,664,509,35,495,510
5906,744,830,86,8,72,87
5907,591,452,-139,57,847,862
5908,591,235,-356,42,630,645
5909,203,926,723,48,709,724
5910,490,70,-420,38,566,581
5911,864,598,-266,49,720,735
5912,494,468,-26,64,960,975
5913,403,29,-374,41,612,627
5914,61,722,661,44,647,662
5915,891,800,-91,60,895,910
5916,789,537,-252,49,734,749
5917,132,20,-112,57,874,889
5918,253,351,98,8,84,99
5919,797,583,-214,51,772,787
5920,548,424,-124,57,862,877
5921,511,836,325,23,311,326
5922,761,346,-415,39,571,586
5923,484,980,496,32,482,497
5924,131,664,533,36,519,534
5925,109,343,234,17,220,235
5926,641,330,-311,45,675,690
5927,514,293,-221,52,765,780
5928,383,9,-374,41,612,627
5929,389,306,-83,60,903,918
5930,205,268,63,8,49,64
5931,643,635,-8,63,978,993
5932,227,816,589,40,575,590
5933,712,402,-310,45,676,691
5934,288,617,329,23,315,330
5935,204,569,365,26,351,366
5936,423,270,-153,57,833,848
5937,221,325,104,8,90,105
5938,364,439,75,8,61,76
5939,226,794,568,37,554,569
5940,555,309,-246,49,740,755
5941,539,97,-442,38,544,559
5942,987,978,-9,66,977,992
5943,621,80,-541,32,445,460
5944,197,331,134,11,120,135
5945,542,772,230,17,216,231
5946,45,699,654,44,640,655
5947,290,548,258,18,244,259
5948,94,168,74,7,60,75
5949,925,64,-861,12,125,140
5950,913,78,-835,13,151,166
5951,39,377,338,23,324,339
5952,526,710,184,13,170,185
5953,146,726,580,38,566,581
5954,532,14,-518,32,468,483
5955,353,388,35,5,21,36
5956,482,796,314,22,300,315
5957,366,148,-218,52,768,783
5958,2,566,564,37,550,565
5959,964,881,-83,60,903,918
5960,239,570,331,24,317,332
5961,321,395,74,7,60,75
5962,512,147,-365,43,621,636
5963,270,995,725,48,711,726
5964,86,695,609,40,595,610
5965,0,134,134,11,120,135
5966,378,23,-355,43,631,646
5967,540,578,38,5,24,39
5968,902,556,-346,44,640,655
5969,449,378,-71,60,915,930
5970,376,624,248,17,234,249
5971,165,348,183,15,169,184
5972,918,463,-455,36,531,546
5973,859,56,-803,15,183,198
5974,438,624,186,14,172,187
5975,906,498,-408,38,578,593
5976,804,184,-620,26,366,381
5977,622,482,-140,56,846,861
5978,252,32,-220,51,766,781
5979,21,548,527,37,513,528
5980,431,858,427,30,413,428
5981,725,373,-352,42,634,649
5982,121,233,112,8,98,113
5983,621,194,-427,39,559,574
5984,180,817,637,43,623,638
5985,625,672,47,7,33,48
5986,805,98,-707,21,279,294
5987,349,210,-139,57,847,862
5988,707,682,-25,65,961,976
5989,553,970,417,28,403,418
5990,239,847,608,39,594,609
5991,989,663,-326,44,660,675
5992,407,989,582,39,568,583
5993,98,415,317,23,303,318
5994,832,546,-286,47,700,715
5995,701,936,235,18,221,236
5996,140,333,193,14,179,194
5997,421,735,314,22,300,315
5998,991,902,-89,61,897,912
5999,252,853,601,40,587,602
6000,35,693,658,43,644,659
6001,66,396,330,23,316,331
6002,970,748,-222,51,764,779
6003,193,591,398,28,384,399
6004,965,195,-770,17,216,231
6005,637,830,193,14,179,194
6006,731,2,-729,21,257,272
6007,516,388,-128,56,858,873
6008,245,576,331,24,317,332
6009,261,449,188,14,174,189
6010,275,280,5,3,3,6
6011,755,411,-344,42,642,657
6012,879,334,-545,32,441,456
6013,52,714,662,44,648,663
6014,458,186,-272,47,714,729
6015,357,26,-331,45,655,670
6016,286,490,204,15,190,205
6017,398,271,-127,57,859,874
6018,635,496,-139,57,847,862
6019,534,696,162,12,148,163
6020,789,477,-312,44,674,689
6021,632,527,-105,60,881,896
6022,792,523,-269,49,717,732
6023,884,532,-352,42,634,649
6024,486,859,373,26,359,374
6025,212,133,-79,60,907,922
6026,19,322,303,23,289,304
6027,39,686,647,44,633,648
6028,751,383,-368,41,618,633
6029,165,361,196,14,182,197
6030,4,865,861,57,847,862
6031,243,52,-191,53,795,810
6032,950,79,-871,10,115,130
6033,437,223,-214,51,772,787
6034,971,216,-755,18,231,246
6035,199,808,609,40,595,610
6036,169,157,-12,64,974,989
6037,466,918,452,30,438,453
6038,645,420,-225,52,761,776
6039,825,929,104,8,90,105
6040,950,131,-819,14,167,182
6041,834,496,-338,44,648,663
6042,369,251,-118,57,868,883
6043,433,546,113,9,99,114
6044,73,262,189,15,175,190
6045,606,11,-595,28,391,406
6046,327,765,438,30,424,439
6047,774,275,-499,34,487,502
6048,742,676,-66,61,920,935
6049,468,669,201,15,187,202
6050,336,900,564,37,550,565
6051,64,954,890,58,876,891
6052,4,398,394,27,380,395
6053,756,94,-662,23,324,339
6054,156,497,341,24,327,342
6055,81,792,711,48,697,712
6056,581,925,344,23,330,345
6057,483,291,-192,52,794,809
6058,528,209,-319,45,667,682
6059,320,204,-116,57,870,885
6060,860,70,-790,15,196,211
6061,220,625,405,28,391,406
6062,859,498,-361,44,625,640
6063,184,973,789,52,775,790
6064,702,339,-363,43,623,638
6065,778,508,-270,48,716,731
6066,387,101,-286,47,700,715
6067,913,652,-261,49,725,740
6068,830,835,5,3,3,6
6069,681,71,-610,27,376,391
6070,428,409,-19,64,967,982
6071,416,580,164,12,150,165
6072,722,773,51,6,37,52
6073,456,342,-114,58,872,887
6074,790,277,-513,34,473,488
6075,65,684,619,42,605,620
6076,557,117,-440,36,546,561
6077,660,918,258,18,244,259
6078,451,576,125,11,111,126
6079,124,468,344,23,330,345
6080,353,571,218,16,204,219
6081,992,375,-617,28,369,384
6082,504,507,3,3,3,4
6083,650,488,-162,55,824,839
6084,209,334,125,11,111,126
6085,421,811,390,27,376,391
6086,250,185,-65,62,921,936
6087,656,458,-198,52,788,803
6088,91,997,906,59,892,907
6089,506,899,393,27,379,394
6090,579,665,86,8,72,87
6091,800,467,-333,45,653,668
6092,272,863,591,41,577,592
6093,570,277,-293,47,693,708
6094,515,304,-211,52,775,790
6095,772,173,-599,27,387,402
6096,87,911,824,53,810,825
6097,978,90,-888,8,98,113
6098,43,864,821,54,807,822
6099,54,349,295,22,281,296
6100,847,834,-13,65,973,988
6101,968,399,-569,31,417,432
6102,759,205,-554,31,432,447
6103,29,265,236,17,222,237
6104,262,767,505,34,491,506
6105,442,864,422,29,408,423
6106,189,450,261,19,247,262
6107,525,546,21,4,7,22
6108,776,844,68,6,54,69
6109,567,524,-43,63,943,958
6110,448,189,-259,49,727,742
6111,303,309,6,3,4,7
6112,658,960,302,22,288,303
6113,82,826,744,48,730,745
6114,595,495,-100,58,886,901
6115,353,113,-240,49,746,761
6116,492,511,19,4,5,20
6117,335,745,410,28,396,411
6118,302,334,32,3,18,33
6119,3,522,519,36,505,520
6120,985,155,-830,13,156,171
6121,284,2,-282,48,704,719
6122,60,677,617,41,603,618
6123,382,822,440,29,426,441
6124,11,428,417,28,403,418
6125,869,907,38,5,24,39
6126,324,620,296,20,282,297
6127,537,253,-284,47,702,717
6128,501,87,-414,39,572,587
6129,279,304,25,4,11,26
6130,217,682,465,31,451,466
6131,953,466,-487,34,499,514
6132,201,892,691,46,677,692
6133,571,567,-4,64,982,997
6134,141,940,799,54,785,800
6135,16,795,779,52,765,780
6136,970,219,-751,18,235,250
6137,619,697,78,8,64,79
6138,573,387,-186,54,800,815
6139,432,261,-171,55,815,830
6140,309,914,605,41,591,606
6141,469,715,246,18,232,247
6142,784,995,211,16,197,212
6143,957,903,-54,61,932,947
6144,36,830,794,52,780,795
6145,537,555,18,3,4,19
6146,127,470,343,25,329,344
6147,481,35,-446,37,540,555
6148,659,702,43,6,29,44
6149,427,957,530,35,516,531
6150,80,45,-35,63,951,966
6151,419,319,-100,58,886,901
6152,23,612,589,40,575,590
6153,573,110,-463,36,523,538
6154,894,810,-84,59,902,917
6155,878,536,-342,43,644,659
6156,903,265,-638,25,348,363
6157,43,920,877,58,863,878
6158,314,807,493,34,479,494
6159,485,879,394,27,380,395
6160,338,925,587,40,573,588
6161,551,935,384,25,370,385
6162,222,138,-84,59,902,917
6163,525,546,21,4,7,22
6164,498,961,463,33,449,464
6165,914,919,5,3,3,6
6166,290,441,151,13,137,152
6167,206,639,433,29,419,434
6168,667,95,-572,29,414,429
6169,626,652,26,4,12,27
6170,180,148,-32,62,954,969
6171,288,839,551,38,537,552
6172,630,853,223,18,209,224
6173,476,37,-439,37,547,562
6174,123,108,-15,64,971,986
6175,219,898,679,46,665,680
6176,891,638,-253,50,733,748
6177,648,213,-435,38,551,566
6178,194,576,382,27,368,383
6179,189,781,592,38,578,593
6180,301,190,-111,58,875,890
6181,82,278,196,14,182,197
6182,711,61,-650,25,336,351
6183,26,189,163,13,149,164
6184,659,582,-77,61,909,924
6185,998,80,-918,7,68,83
6186,204,742,538,36,524,539
6187,658,337,-321,46,665,680
6188,160,935,775,52,761,776
6189,153,547,394,27,380,395
6190,561,950,389,27,375,390
6191,169,424,255,20,241,256
6192,711,420,-291,47,695,710
6193,171,422,251,19,237,252
6194,440,952,512,33,498,513
6195,570,697,127,12,113,128
6196,74,841,767,52,753,768
6197,784,278,-506,34,480,495
6198,622,653,31,6,17,32
6199,5,910,905,59,891,906
6200,590,248,-342,43,644,659
6201,32,819,787,52,773,788
6202,179,871,692,45,678,693
6203,352,656,304,20,290,305
6204,748,869,121,10,107,122
6205,582,772,190,15,176,191
6206,484,975,491,34,477,492
6207,314,879,565,38,551,566
6208,841,566,-275,48,711,726
6209,961,96,-865,12,121,136
6210,706,95,-611,27,375,390
6211,690,31,-659,24,327,342
6212,416,418,2,2,2,3
6213,992,834,-158,55,828,843
6214,680,346,-334,44,652,667
6215,103,843,740,48,726,741
6216,499,81,-418,39,568,583
6217,22,37,15,5,9,16
6218,986,526,-460,36,526,541
6219,968,5,-963,5,23,38
6220,475,651,176,12,162,177
6221,427,492,65,6,51,66
6222,921,306,-615,26,371,386
6223,480,535,55,7,41,56
6224,221,748,527,37,513,528
6225,895,530,-365,43,621,636
6226,909,352,-557,31,429,444
6227,563,263,-300,46,686,701
6228,347,475,128,9,114,129
6229,558,619,61,7,47,62
6230,920,491,-429,39,557,572
6231,916,663,-253,50,733,748
6232,860,309,-551,30,435,450
6233,65,569,504,33,490,505
6234,735,225,-510,33,476,491
6235,311,153,-158,55,828,843
6236,712,278,-434,38,552,567
6237,564,207,-357,43,629,644
6238,231,0,-231,50,755,770
6239,703,189,-514,33,472,487
6240,163,686,523,36,509,524
6241,856,144,-712,19,274,289
6242,305,867,562,37,548,563
6243,409,284,-125,58,861,876
6244,986,773,-213,52,773,788
6245,716,345,-371,42,615,630
6246,22,326,304,20,290,305
6247,20,69,49,5,35,50
6248,942,742,-200,51,786,801
6249,503,62,-441,39,545,560
6250,931,728,-203,53,783,798
6251,827,762,-65,62,921,936
6252,764,216,-548,30,438,453
6253,359,357,-2,65,984,999
6254,541,579,38,5,24,39
6255,750,66,-684,22,302,317
6256,604,661,57,6,43,58
6257,495,857,362,25,348,363
6258,819,862,43,6,29,44
6259,668,719,51,6,37,52
6260,913,562,-351,43,635,650
6261,0,742,742,49,728,743
6262,668,96,-572,29,414,429
6263,234,739,505,34,491,506
6264,274,247,-27,64,959,974
6265,484,56,-428,38,558,573
6266,268,651,383,28,369,384
6267,940,827,-113,59,873,888
6268,497,419,-78,60,908,923
6269,627,546,-81,61,905,920
6270,42,151,109,10,95,110
6271,638,970,332,23,318,333
6272,80,819,739,49,725,740
6273,255,600,345,24,331,346
6274,200,422,222,17,208,223
6275,541,425,-116,57,870,885
6276,814,258,-556,30,430,445
6277,309,238,-71,60,915,930
6278,266,364,98,8,84,99
6279,335,979,644,42,630,645
6280,551,877,326,23,312,327
6281,686,476,-210,52,776,791
6282,922,410,-512,32,474,489
6283,121,862,741,49,727,742
6284,936,767,-169,56,817,832
6285,372,809,437,30,423,438
6286,272,620,348,24,334,349
6287,524,477,-47,62,939,954
6288,828,110,-718,20,268,283
6289,68,751,683,46,669,684
6290,24,56,32,3,18,33
6291,629,865,236,17,222,237
6292,175,795,620,41,606,621
6293,614,746,132,10,118,133
6294,728,922,194,14,180,195
6295,30,821,791,53,777,792
6296,634,335,-299,47,687,702
6297,89,107,18,3,4,19
6298,867,731,-136,55,850,865
6299,909,972,63,8,49,64
6300,221,143,-78,60,908,923
6301,15,648,633,42,619,634
6302,210,220,10,3,4,11
6303,75,358,283,21,269,284
6304,247,564,317,23,303,318
6305,749,163,-586,29,400,415
6306,694,472,-222,51,764,779
6307,940,862,-78,60,908,923
6308,164,77,-87,59,899,914
6309,630,154,-476,35,510,525
6310,437,722,285,21,271,286
6311,242,494,252,18,238,253
6312,426,888,462,32,448,463
6313,952,432,-520,31,466,481
6314,628,865,237,18,223,238
6315,248,81,-167,54,819,834
6316,647,275,-372,41,614,629
6317,535,135,-400,39,586,601
6318,948,142,-806,14,180,195
6319,293,57,-236,50,750,765
6320,755,259,-496,33,490,505
6321,689,539,-150,55,836,851
6322,312,857,545,36,531,546
6323,14,262,248,17,234,249
6324,744,986,242,17,228,243
6325,800,950,150,12,136,151
6326,594,651,57,6,43,58
6327,678,644,-34,63,952,967
6328,591,240,-351,43,635,650
6329,537,167,-370,42,616,631
6330,777,554,-223,51,763,778
6331,926,326,-600,26,386,401
6332,545,506,-39,62,947,962
6333,703,89,-614,26,372,387
6334,376,339,-37,63,949,964
6335,736,429,-307,46,679,694
6336,400,394,-6,64,980,995
6337,60,469,409,28,395,410
6338,225,575,350,25,336,351
6339,785,866,81,7,67,82
6340,897,693,-204,52,782,797
6341,160,867,707,47,693,708
6342,139,818,679,46,665,680
6343,944,879,-65,62,921,936
6344,347,685,338,23,324,339
6345,840,551,-289,48,697,712
6346,326,761,435,30,421,436
6347,392,33,-359,42,627,642
6348,493,358,-135,56,851,866
6349,876,783,-93,60,893,908
6350,816,51,-765,18,221,236
6351,297,204,-93,60,893,908
6352,336,616,280,19,266,281
6353,771,927,156,12,142,157
6354,793,296,-497,35,489,504
6355,82,380,298,21,284,299
6356,67,63,-4,64,982,997
6357,224,650,426,29,412,427
6358,667,23,-644,24,342,357
6359,354,652,298,21,284,299
6360,990,586,-404,39,582,597
6361,415,510,95,10,81,96
6362,304,81,-223,51,763,778
6363,362,878,516,34,502,517
6364,322,832,510,35,496,511
6365,52,896,844,55,830,845
6366,850,927,77,8,63,78
6367,156,945,789,52,775,790
6368,148,129,-19,64,967,982
6369,784,389,-395,41,591,606
6370,786,789,3,3,3,4
6371,743,396,-347,44,639,654
6372,564,791,227,17,213,228
6373,380,504,124,10,110,125
6374,28,895,867,57,853,868
6375,868,462,-406,39,580,595
6376,90,500,410,28,396,411
6377,265,441,176,12,162,177
6378,412,347,-65,62,921,936
6379,86,839,753,49,739,754
6380,730,768,38,5,24,39
6381,932,765,-167,54,819,834
6382,185,869,684,45,670,685
6383,562,570,8,2,2,9
6384,508,25,-483,35,503,518
6385,519,823,304,20,290,305
6386,744,924,180,13,166,181
6387,912,510,-402,40,584,599
6388,685,287,-398,40,588,603
6389,424,608,184,13,170,185
6390,656,549,-107,59,879,894
6391,538,953,415,30,401,416
6392,508,882,374,26,360,375
6393,938,413,-525,33,461,476
6394,829,271,-558,30,428,443
6395,826,131,-695,21,291,306
6396,409,138,-271,48,715,730
6397,431,739,308,21,294,309
6398,200,619,419,29,405,420
6399,140,31,-109,59,877,892
6400,385,660,275,20,261,276
6401,853,240,-613,27,373,388
6402,510,316,-194,53,792,807
6403,827,305,-522,33,464,479
6404,91,758,667,45,653,668
6405,943,424,-519,32,467,482
6406,311,726,415,30,401,416
6407,347,514,167,14,153,168
6408,279,252,-27,64,959,974
6409,817,640,-177,55,809,824
6410,27,720,693,46,679,694
6411,806,984,178,13,164,179
6412,838,430,-408,38,578,593
6413,663,98,-565,30,421,436
6414,804,70,-734,19,252,267
6415,837,551,-286,47,700,715
6416,197,24,-173,55,813,828
6417,457,329,-128,56,858,873
6418,557,261,-296,45,690,705
6419,721,755,34,4,20,35
6420,633,303,-330,45,656,671
6421,65,402,337,23,323,338
6422,110,978,868,56,854,869
6423,222,269,47,7,33,48
6424,158,838,680,44,666,681
6425,751,598,-153,57,833,848
6426,968,341,-627,26,359,374
6427,691,757,66,6,52,67
6428,28,942,914,59,900,915
6429,312,339,27,5,13,28
6430,176,26,-150,55,836,851
6431,287,330,43,6,29,44
6432,960,119,-841,14,145,160
6433,422,221,-201,54,785,800
6434,124,691,567,39,553,568
6435,615,507,-108,58,878,893
6436,211,100,-111,58,875,890
6437,718,652,-66,61,920,935
6438,366,959,593,39,579,594
6439,569,920,351,26,337,352
6440,206,696,490,33,476,491
6441,377,804,427,30,413,428
6442,201,731,530,35,516,531
6443,248,309,61,7,47,62
6444,381,179,-202,53,784,799
6445,14,646,632,41,618,633
6446,368,723,355,25,341,356
6447,255,782,527,37,513,528
6448,281,286,5,3,3,6
6449,915,624,-291,47,695,710
6450,557,216,-341,44,645,660
6451,138,162,24,3,10,25
6452,140,387,247,19,233,248
6453,199,321,122,10,108,123
6454,121,120,-1,66,985,1000
6455,16,503,487,34,473,488
6456,406,688,282,20,268,283
6457,765,940,175,15,161,176
6458,839,871,32,3,18,33
6459,513,736,223,18,209,224
6460,782,932,150,12,136,151
6461,211,899,688,44,674,689
6462,327,529,202,15,188,203
6463,170,639,469,32,455,470
6464,762,150,-612,26,374,389
6465,285,327,42,5,28,43
6466,371,386,15,5,9,16
6467,725,155,-570,30,416,431
6468,267,635,368,24,354,369
6469,141,943,802,52,788,803
6470,301,816,515,35,501,516
6471,952,495,-457,38,529,544
6472,497,577,80,6,66,81
6473,717,409,-308,45,678,693
6474,404,151,-253,50,733,748
6475,358,809,451,31,437,452
6476,457,963,506,34,492,507
6477,915,937,22,4,8,23
6478,870,675,-195,53,791,806
6479,716,64,-652,24,334,349
6480,884,256,-628,25,358,373
6481,964,384,-580,28,406,421
6482,217,246,29,5,15,30
6483,355,42,-313,47,673,688
6484,669,28,-641,26,345,360
6485,564,884,320,21,306,321
6486,76,246,170,13,156,171
6487,965,686,-279,47,707,722
6488,395,902,507,35,493,508
6489,450,449,-1,66,985,1000
6490,799,337,-462,36,524,539
6491,126,208,82,7,68,83
6492,190,51,-139,57,847,862
6493,75,226,151,13,137,152
6494,446,269,-177,55,809,824
6495,569,278,-291,47,695,710
6496,73,412,339,24,325,340
6497,574,836,262,19,248,263
6498,277,100,-177,55,809,824
6499,120,704,584,38,570,585
6500,89,757,668,44,654,669
6501,605,809,204,15,190,205
6502,461,86,-375,41,611,626
6503,455,9,-446,37,540,555
6504,629,167,-462,36,524,539
6505,306,436,130,10,116,131
6506,576,473,-103,58,883,898
6507,746,975,229,17,215,230
6508,246,362,116,9,102,117
6509,445,255,-190,53,796,811
6510,245,188,-57,63,929,944
6511,920,612,-308,45,678,693
6512,899,297,-602,28,384,399
6513,204,315,111,11,97,112
6514,903,214,-689,23,297,312
6515,669,93,-576,28,410,425
6516,303,316,13,4,7,14
6517,741,775,34,4,20,35
6518,37,319,282,20,268,283
6519,901,295,-606,27,380,395
6520,428,115,-313,47,673,688
6521,736,980,244,17,230,245
6522,126,774,648,42,634,649
6523,757,441,-316,45,670,685
6524,791,192,-599,27,387,402
6525,287,736,449,30,435,450
6526,176,49,-127,57,859,874
6527,201,539,338,23,324,339
6528,289,115,-174,54,812,827
6529,187,921,734,49,720,735
6530,653,629,-24,62,962,977
6531,605,664,59,7,45,60
6532,520,557,37,5,23,38
6533,426,527,101,9,87,102
6534,969,477,-492,34,494,509
6535,483,246,-237,51,749,764
6536,746,829,83,8,69,84
6537,31,153,122,10,108,123
6538,47,640,593,39,579,594
6539,714,15,-699,22,287,302
6540,338,499,161,12,147,162
6541,281,960,679,46,665,680
6542,795,58,-737,20,249,264
6543,27,586,559,39,545,560
6544,903,733,-170,55,816,831
6545,690,450,-240,49,746,761
6546,284,330,46,6,32,47
6547,185,600,415,30,401,416
6548,202,442,240,16,226,241
6549,180,685,505,34,491,506
6550,813,509,-304,45,682,697
6551,516,236,-280,46,706,721
6552,911,364,-547,31,439,454
6553,475,282,-193,54,793,808
6554,122,147,25,4,11,26
6555,439,855,416,27,402,417
6556,504,400,-104,57,882,897
6557,280,366,86,8,72,87
6558,15,398,383,28,369,384
6559,819,261,-558,30,428,443
6560,696,82,-614,26,372,387
6561,570,964,394,27,380,395
6562,170,348,178,13,164,179
6563,654,465,-189,54,797,812
6564,211,987,776,50,762,777
6565,658,982,324,22,310,325
6566,219,132,-87,59,899,914
6567,507,512,5,3,3,6
6568,872,460,-412,39,574,589
6569,655,669,14,4,8,15
6570,76,574,498,33,484,499
6571,283,879,596,39,582,597
6572,539,46,-493,35,493,508
6573,15,916,901,59,887,902
6574,613,166,-447,37,539,554
6575,672,397,-275,48,711,726
6576,512,497,-15,64,971,986
6577,135,715,580,38,566,581
6578,208,340,132,10,118,133
6579,703,341,-362,43,624,639
6580,108,438,330,23,316,331
6581,522,230,-292,46,694,709
6582,975,584,-391,40,595,610
6583,177,449,272,18,258,273
6584,981,380,-601,29,385,400
6585,993,670,-323,45,663,678
6586,664,439,-225,52,761,776
6587,526,821,295,22,281,296
6588,233,199,-34,63,952,967
6589,903,447,-456,35,530,545
6590,817,322,-495,34,491,506
6591,955,673,-282,48,704,719
6592,624,396,-228,50,758,773
6593,569,740,171,14,157,172
6594,3,873,870,57,856,871
6595,623,262,-361,44,625,640
6596,65,25,-40,61,946,961
6597,216,141,-75,61,911,926
6598,338,386,48,4,34,49
6599,97,823,726,48,712,727
6600,835,700,-135,56,851,866
6601,610,17,-593,29,393,408
6602,160,942,782,52,768,783
6603,703,886,183,15,169,184
6604,33,701,668,44,654,669
6605,419,681,262,19,248,263
6606,403,280,-123,58,863,878
6607,422,497,75,8,61,76
6608,558,0,-558,30,428,443
6609,410,389,-21,64,965,980
6610,874,194,-680,21,306,321
6611,588,911,323,23,309,324
6612,576,407,-169,56,817,832
6613,156,642,486,33,472,487
6614,898,308,-590,28,396,411
6615,205,767,562,37,548,563
6616,988,424,-564,29,422,437
6617,788,32,-756,17,230,245
6618,816,281,-535,31,451,466
6619,417,886,469,32,455,470
6620,221,662,441,30,427,442
6621,44,279,235,18,221,236
6622,987,872,-115,58,871,886
6623,716,51,-665,25,321,336
6624,607,581,-26,64,960,975
6625,604,816,212,15,198,213
6626,542,39,-503,33,483,498
6627,497,385,-112,57,874,889
6628,322,942,620,41,606,621
6629,970,284,-686,22,300,315
6630,638,41,-597,28,389,404
6631,861,823,-38,62,948,963
6632,868,472,-396,40,590,605
6633,898,526,-372,41,614,629
6634,403,158,-245,50,741,756
6635,742,190,-552,29,434,449
6636,157,586,429,30,415,430
6637,41,158,117,10,103,118
6638,784,418,-366,42,620,635
6639,774,811,37,5,23,38
6640,891,962,71,8,57,72
6641,691,141,-550,30,436,451
6642,679,753,74,7,60,75
6643,533,955,422,29,408,423
6644,223,950,727,49,713,728
6645,162,178,16,2,2,17
6646,974,316,-658,24,328,343
6647,739,955,216,15,202,217
6648,162,676,514,34,500,515
6649,661,548,-113,59,873,888
6650,227,496,269,20,255,270
6651,478,250,-228,50,758,773
6652,471,210,-261,49,725,740
6653,662,975,313,22,299,314
6654,930,955,25,4,11,26
6655,915,570,-345,45,641,656
6656,53,228,175,15,161,176
6657,266,194,-72,59,914,929
6658,407,541,134,11,120,135
6659,622,941,319,24,305,320
6660,177,291,114,9,100,115
6661,76,305,229,17,215,230
6662,103,999,896,57,882,897
6663,395,490,95,10,81,96
6664,496,53,-443,38,543,558
6665,530,976,446,31,432,447
6666,117,913,796,52,782,797
6667,701,94,-607,27,379,394
6668,883,939,56,5,42,57
6669,761,332,-429,39,557,572
6670,700,56,-644,24,342,357
6671,776,650,-126,57,860,875
6672,575,597,22,4,8,23
6673,185,412,227,17,213,228
6674,812,668,-144,55,842,857
6675,645,548,-97,60,889,904
6676,300,512,212,15,198,213
6677,771,790,19,4,5,20
6678,870,133,-737,20,249,264
6679,994,702,-292,46,694,709
6680,494,932,438,30,424,439
6681,55,15,-40,61,946,961
6682,145,846,701,47,687,702
6683,216,981,765,51,751,766
6684,555,662,107,10,93,108
6685,241,436,195,15,181,196
6686,371,130,-241,51,745,760
6687,586,558,-28,63,958,973
6688,391,273,-118,57,868,883
6689,798,630,-168,53,818,833
6690,28,926,898,58,884,899
6691,108,665,557,38,543,558
6692,466,743,277,20,263,278
6693,175,675,500,33,486,501
6694,603,712,109,10,95,110
6695,527,62,-465,37,521,536
6696,287,687,400,26,386,401
6697,573,544,-29,64,957,972
6698,701,424,-277,48,709,724
6699,201,315,114,9,100,115
6700,219,2,-217,53,769,784
6701,152,784,632,41,618,633
6702,134,828,694,46,680,695
6703,985,739,-246,49,740,755
6704,536,154,-382,41,604,619
6705,16,765,749,50,735,750
6706,370,823,453,31,439,454
6707,906,26,-880,9,106,121
6708,308,339,31,6,17,32
6709,798,56,-742,18,244,259
6710,750,272,-478,35,508,523
6711,196,75,-121,59,865,880
6712,835,350,-485,35,501,516
6713,15,363,348,24,334,349
6714,755,777,22,4,8,23
6715,109,77,-32,62,954,969
6716,191,438,247,19,233,248
6717,641,841,200,14,186,201
6718,696,100,-596,27,390,405
6719,714,352,-362,43,624,639
6720,825,465,-360,41,626,641
6721,59,807,748,49,734,749
6722,717,79,-638,25,348,363
6723,97,191,94,9,80,95
6724,985,197,-788,15,198,213
6725,559,782,223,18,209,224
6726,261,773,512,33,498,513
6727,621,364,-257,50,729,744
6728,691,838,147,12,133,148
6729,845,753,-92,59,894,909
6730,4,400,396,27,382,397
6731,90,715,625,41,611,626
6732,983,624,-359,42,627,642
6733,677,121,-556,30,430,445
6734,500,181,-319,45,667,682
6735,497,470,-27,64,959,974
6736,305,132,-173,55,813,828
6737,38,238,200,14,186,201
6738,347,34,-313,47,673,688
6739,292,8,-284,47,702,717
6740,736,969,233,17,219,234
6741,655,105,-550,30,436,451
6742,637,225,-412,39,574,589
6743,215,216,1,2,2,2
6744,352,440,88,7,74,89
6745,46,266,220,16,206,221
6746,320,862,542,37,528,543
6747,514,162,-352,42,634,649
6748,84,708,624,40,610,625
6749,473,49,-424,37,562,577
6750,511,693,182,14,168,183
6751,600,295,-305,47,681,696
6752,657,469,-188,53,798,813
6753,210,916,706,46,692,707
6754,871,34,-837,13,149,164
6755,247,544,297,21,283,298
6756,158,220,62,7,48,63
6757,304,538,234,17,220,235
6758,628,204,-424,37,562,577
6759,315,852,537,36,523,538
6760,601,218,-383,41,603,618
6761,749,486,-263,48,723,738
6762,130,149,19,4,5,20
6763,432,992,560,36,546,561
6764,691,115,-576,28,410,425
6765,887,606,-281,49,705,720
6766,812,260,-552,29,434,449
6767,182,728,546,36,532,547
6768,791,849,58,6,44,59
6769,519,963,444,30,430,445
6770,589,979,390,27,376,391
6771,81,652,571,39,557,572
6772,639,58,-581,29,405,420
6773,76,560,484,32,470,485
6774,588,441,-147,56,839,854
6775,945,182,-763,18,223,238
6776,415,373,-42,63,944,959
6777,365,942,577,38,563,578
6778,953,893,-60,61,926,941
6779,301,369,68,6,54,69
6780,945,405,-540,31,446,461
6781,366,962,596,39,582,597
6782,550,923,373,26,359,374
6783,940,991,51,6,37,52
6784,168,436,268,19,254,269
6785,603,249,-354,43,632,647
6786,154,990,836,54,822,837
6787,177,313,136,10,122,137
6788,260,41,-219,52,767,782
6789,862,12,-850,12,136,151
6790,757,9,-748,18,238,253
6791,707,92,-615,26,371,386
6792,469,621,152,11,138,153
6793,803,918,115,10,101,116
6794,817,481,-336,43,650,665
6795,81,2,-79,60,907,922
6796,473,796,323,23,309,324
6797,253,649,396,27,382,397
6798,221,953,732,48,718,733
6799,503,873,370,25,356,371
6800,741,922,181,14,167,182
6801,899,289,-610,27,376,391
6802,173,373,200,14,186,201
6803,321,88,-233,52,753,768
6804,243,557,314,22,300,315
6805,333,195,-138,57,848,863
6806,233,466,233,17,219,234
6807,925,913,-12,64,974,989
6808,1,200,199,16,185,200
6809,773,656,-117,58,869,884
6810,369,228,-141,57,845,860
6811,613,488,-125,58,861,876
6812,735,185,-550,30,436,451
6813,669,289,-380,41,606,621
6814,903,504,-399,40,587,602
6815,589,392,-197,53,789,804
6816,297,687,390,27,376,391
6817,421,514,93,9,79,94
6818,741,484,-257,50,729,744
6819,507,972,465,31,451,466
6820,592,424,-168,53,818,833
6821,51,17,-34,63,952,967
6822,434,37,-397,41,589,604
6823,625,754,129,10,115,130
6824,304,271,-33,64,953,968
6825,327,806,479,34,465,480
6826,786,827,41,5,27,42
6827,485,871,386,26,372,387
6828,970,135,-835,13,151,166
6829,150,293,143,13,129,144
6830,443,102,-341,44,645,660
6831,541,92,-449,38,537,552
6832,611,876,265,19,251,266
6833,999,578,-421,39,565,580
6834,358,296,-62,61,924,939
6835,112,838,726,48,712,727
6836,94,658,564,37,550,565
6837,325,453,128,9,114,129
6838,315,661,346,24,332,347
6839,162,761,599,41,585,600
6840,818,157,-661,24,325,340
6841,641,135,-506,34,480,495
6842,595,995,400,26,386,401
6843,53,321,268,19,254,269
6844,664,743,79,9,65,80
6845,23,125,102,9,88,103
6846,813,168,-645,25,341,356
6847,970,479,-491,35,495,510
6848,935,217,-718,20,268,283
6849,267,656,389,27,375,390
6850,216,384,168,12,154,169
6851,175,562,387,27,373,388
6852,271,183,-88,58,898,913
6853,500,930,430,30,416,431
6854,649,33,-616,25,370,385
6855,362,305,-57,63,929,944
6856,644,627,-17,65,969,984
6857,682,544,-138,57,848,863
6858,836,512,-324,44,662,677
6859,736,837,101,9,87,102
6860,103,632,529,35,515,530
6861,843,979,136,10,122,137
6862,699,521,-178,54,808,823
6863,423,686,263,20,249,264
6864,295,421,126,11,112,127
6865,871,565,-306,46,680,695
6866,439,340,-99,59,887,902
6867,576,583,7,4,5,8
6868,502,192,-310,45,676,691
6869,965,616,-349,44,637,652
6870,531,321,-210,52,776,791
6871,344,948,604,40,590,605
6872,345,661,316,22,302,317
6873,116,144,28,4,14,29
6874,556,381,-175,54,811,826
6875,196,456,260,18,246,261
6876,94,513,419,29,405,420
6877,198,106,-92,59,894,909
6878,484,635,151,13,137,152
6879,560,422,-138,57,848,863
6880,146,754,608,39,594,609
6881,217,315,98,8,84,99
6882,886,729,-157,56,829,844
6883,532,416,-116,57,870,885
6884,249,568,319,24,305,320
6885,928,676,-252,49,734,749
6886,834,821,-13,65,973,988
6887,423,685,262,19,248,263
6888,363,747,384,25,370,385
6889,918,699,-219,52,767,782
6890,18,642,624,40,610,625
6891,287,136,-151,55,835,850
6892,781,122,-659,24,327,342
6893,557,816,259,19,245,260
6894,274,248,-26,64,960,975
6895,895,478,-417,40,569,584
6896,293,915,622,42,608,623
6897,348,577,229,17,215,230
6898,708,631,-77,61,909,924
6899,512,513,1,2,2,2
6900,400,428,28,4,14,29
6901,343,114,-229,51,757,772
6902,134,299,165,13,151,166
6903,258,112,-146,56,840,855
6904,906,176,-730,20,256,271
6905,903,373,-530,32,456,471
6906,371,200,-171,55,815,830
6907,899,597,-302,46,684,699
6908,399,552,153,12,139,154
6909,131,714,583,40,569,584
6910,539,963,424,28,410,425
6911,253,402,149,12,135,150
6912,591,270,-321,46,665,680
6913,632,296,-336,43,650,665
6914,554,816,262,19,248,263
6915,262,579,317,23,303,318
6916,647,243,-404,39,582,597
6917,255,866,611,41,597,612
6918,777,679,-98,59,888,903
6919,441,584,143,13,129,144
6920,441,923,482,32,468,483
6921,12,680,668,44,654,669
6922,714,189,-525,33,461,476
6923,677,980,303,23,289,304
6924,851,111,-740,18,246,261
6925,457,971,514,34,500,515
6926,318,414,96,7,82,97
6927,597,427,-170,55,816,831
6928,399,542,143,13,129,144
6929,838,579,-259,49,727,742
6930,272,953,681,45,667,682
6931,148,644,496,32,482,497
6932,470,319,-151,55,835,850
6933,88,136,48,4,34,49
6934,532,789,257,18,243,258
6935,318,619,301,22,287,302
6936,17,396,379,27,365,380
6937,132,670,538,36,524,539
6938,400,81,-319,45,667,682
6939,640,996,356,24,342,357
6940,893,872,-21,64,965,980
6941,266,396,130,10,116,131
6942,266,733,467,32,453,468
6943,488,247,-241,51,745,760
6944,768,973,205,16,191,206
6945,318,694,376,25,362,377
6946,156,546,390,27,376,391
6947,916,961,45,6,31,46
6948,103,805,702,47,688,703
6949,478,774,296,20,282,297
6950,244,987,743,50,729,744
6951,833,705,-128,56,858,873
6952,654,288,-366,42,620,635
6953,977,54,-923,8,63,78
6954,297,214,-83,60,903,918
6955,601,68,-533,32,453,468
6956,392,280,-112,57,874,889
6957,565,24,-541,32,445,460
6958,807,372,-435,38,551,566
6959,939,232,-707,21,279,294
6960,116,727,611,41,597,612
6961,199,84,-115,58,871,886
6962,30,42,12,3,6,13
6963,902,791,-111,58,875,890
6964,226,388,162,12,148,163
6965,393,200,-193,54,793,808
6966,128,965,837,55,823,838
6967,707,4,-703,21,283,298
6968,813,648,-165,55,821,836
6969,973,815,-158,55,828,843
6970,461,326,-135,56,851,866
6971,369,509,140,11,126,141
6972,602,166,-436,37,550,565
6973,899,304,-595,28,391,406
6974,879,908,29,5,15,30
6975,892,92,-800,14,186,201
6976,106,710,604,40,590,605
6977,983,591,-392,39,594,609
6978,741,5,-736,18,250,265
6979,449,835,386,26,372,387
6980,271,914,643,43,629,644
6981,500,424,-76,60,910,925
6982,233,127,-106,59,880,895
6983,50,777,727,49,713,728
6984,731,996,265,19,251,266
6985,611,79,-532,31,454,469
6986,749,139,-610,27,376,391
6987,282,183,-99,59,887,902
6988,490,547,57,6,43,58
6989,250,367,117,10,103,118
6990,19,171,152,11,138,153
6991,444,644,200,14,186,201
6992,651,902,251,19,237,252
6993,560,117,-443,38,543,558
6994,788,847,59,7,45,60
6995,34,734,700,46,686,701
6996,378,910,532,35,518,533
6997,390,597,207,17,193,208
6998,155,407,252,18,238,253
6999,500,33,-467,36,519,534
7000,742,583,-159,55,827,842
7001,889,284,-605,28,381,396
7002,806,677,-129,58,857,872
7003,533,275,-258,49,728,743
7004,924,24,-900,8,86,101
7005,624,397,-227,51,759,774
7006,993,167,-826,14,160,175
7007,737,773,36,4,22,37
7008,587,517,-70,60,916,931
7009,114,753,639,44,625,640
7010,766,972,206,16,192,207
7011,89,37,-52,61,934,949
7012,136,681,545,36,531,546
7013,476,138,-338,44,648,663
7014,409,284,-125,58,861,876
7015,284,547,263,20,249,264
7016,647,842,195,15,181,196
7017,762,772,10,3,4,11
7018,918,9,-909,9,77,92
7019,89,989,900,58,886,901
7020,434,347,-87,59,899,914
7021,865,472,-393,42,593,608
7022,852,792,-60,61,926,941
7023,973,890,-83,60,903,918
7024,892,156,-736,18,250,265
7025,925,992,67,7,53,68
7026,936,533,-403,40,583,598
7027,607,686,79,9,65,80
7028,748,823,75,8,61,76
7029,838,39,-799,15,187,202
7030,401,604,203,16,189,204
7031,247,240,-7,64,979,994
7032,65,850,785,51,771,786
7033,910,105,-805,15,181,196
7034,177,285,108,9,94,109
7035,238,320,82,7,68,83
7036,805,274,-531,32,455,470
7037,129,119,-10,65,976,991
7038,823,524,-299,47,687,702
7039,756,838,82,7,68,83
7040,24,600,576,37,562,577
7041,498,574,76,7,62,77
7042,728,129,-599,27,387,402
7043,529,39,-490,35,496,511
7044,136,431,295,22,281,296
7045,468,194,-274,48,712,727
7046,563,948,385,26,371,386
7047,614,616,2,2,2,3
7048,628,177,-451,37,535,550
7049,470,44,-426,39,560,575
7050,409,403,-6,64,980,995
7051,860,729,-131,57,855,870
7052,597,960,363,26,349,364
7053,925,477,-448,36,538,553
7054,234,94,-140,56,846,861
7055,993,694,-299,47,687,702
7056,225,762,537,36,523,538
7057,891,241,-650,25,336,351
7058,715,119,-596,27,390,405
7059,899,640,-259,49,727,742
7060,911,410,-501,34,485,500
7061,697,265,-432,37,554,569
7062,411,318,-93,60,893,908
7063,70,31,-39,62,947,962
7064,859,171,-688,21,298,313
7065,475,156,-319,45,667,682
7066,834,505,-329,46,657,672
7067,955,318,-637,26,349,364
7068,782,18,-764,17,222,237
7069,685,94,-591,28,395,410
7070,453,165,-288,46,698,713
7071,705,824,119,11,105,120
7072,988,862,-126,57,860,875
7073,524,424,-100,58,886,901
7074,640,527,-113,59,873,888
7075,754,462,-292,46,694,709
7076,841,553,-288,46,698,713
7077,724,966,242,17,228,243
7078,884,901,17,3,3,18
7079,259,13,-246,49,740,755
7080,685,855,170,13,156,171
7081,241,497,256,17,242,257
7082,863,718,-145,57,841,856
7083,274,392,118,10,104,119
7084,818,431,-387,41,599,614
7085,337,538,201,15,187,202
7086,835,899,64,5,50,65
7087,485,358,-127,57,859,874
7088,878,375,-503,33,483,498
7089,523,351,-172,54,814,829
7090,653,84,-569,31,417,432
7091,36,270,234,17,220,235
7092,328,294,-34,63,952,967
7093,13,648,635,43,621,636
7094,132,610,478,33,464,479
7095,794,3,-791,15,195,210
7096,949,391,-558,30,428,443
7097,506,262,-244,49,742,757
7098,545,300,-245,50,741,756
7099,737,477,-260,48,726,741
7100,960,296,-664,22,322,337
7101,128,669,541,37,527,542
7102,914,396,-518,32,468,483
7103,167,597,430,30,416,431
7104,577,704,127,12,113,128
7105,554,166,-388,40,598,613
7106,493,903,410,28,396,411
7107,56,454,398,28,384,399
7108,554,330,-224,50,762,777
7109,429,519,90,8,76,91
7110,881,414,-467,36,519,534
7111,929,964,35,5,21,36
7112,762,340,-422,38,564,579
7113,256,849,593,39,579,594
7114,21,518,497,33,483,498
7115,842,47,-795,16,191,206
7116,235,652,417,28,403,418
7117,150,569,419,29,405,420
7118,284,405,121,10,107,122
7119,586,7,-579,29,407,422
7120,406,804,398,28,384,399
7121,414,95,-319,45,667,682
7122,134,190,56,5,42,57
7123,80,786,706,46,692,707
7124,82,238,156,12,142,157
7125,371,77,-294,46,692,707
7126,144,29,-115,58,871,886
7127,754,557,-197,53,789,804
7128,113,848,735,50,721,736
7129,232,832,600,39,586,601
7130,613,44,-569,31,417,432
7131,600,347,-253,50,733,748
7132,815,598,-217,53,769,784
7133,744,871,127,12,113,128
7134,571,245,-326,44,660,675
7135,610,592,-18,64,968,983
7136,23,521,498,33,484,499
7137,497,840,343,25,329,344
7138,318,365,47,7,33,48
7139,946,459,-487,34,499,514
7140,943,607,-336,43,650,665
7141,222,249,27,5,13,28
7142,38,825,787,52,773,788
7143,530,498,-32,62,954,969
7144,108,204,96,7,82,97
7145,917,406,-511,33,475,490
7146,273,85,-188,53,798,813
7147,766,787,21,4,7,22
7148,672,156,-516,32,470,485
7149,904,342,-562,30,424,439
7150,326,372,46,6,32,47
7151,625,87,-538,32,448,463
7152,305,370,65,6,51,66
7153,666,63,-603,28,383,398
7154,893,796,-97,60,889,904
7155,81,987,906,59,892,907
7156,119,63,-56,60,930,945
7157,156,808,652,43,638,653
7158,248,854,606,41,592,607
7159,481,83,-398,40,588,603
7160,79,775,696,45,682,697
7161,937,443,-494,34,492,507
7162,231,456,225,16,211,226
7163,598,180,-418,39,568,583
7164,248,726,478,33,464,479
7165,864,584,-280,46,706,721
7166,369,646,277,20,263,278
7167,944,530,-414,39,572,587
7168,149,911,762,50,748,763
7169,810,328,-482,35,504,519
7170,659,473,-186,54,800,815
7171,801,72,-729,21,257,272
7172,544,334,-210,52,776,791
7173,98,145,47,7,33,48
7174,139,255,116,9,102,117
7175,791,367,-424,37,562,577
7176,675,391,-284,47,702,717
7177,856,693,-163,55,823,838
7178,755,22,-733,20,253,268
7179,660,901,241,17,227,242
7180,359,515,156,12,142,157
7181,894,190,-704,20,282,297
7182,568,998,430,30,416,431
7183,346,364,18,3,4,19
7184,837,86,-751,18,235,250
7185,19,697,678,45,664,679
7186,298,745,447,32,433,448
7187,416,411,-5,65,981,996
7188,675,837,162,12,148,163
7189,767,902,135,12,121,136
7190,187,19,-168,53,818,833
7191,773,692,-81,61,905,920
7192,133,923,790,52,776,791
7193,150,5,-145,57,841,856
7194,406,999,593,39,579,594
7195,52,530,478,33,464,479
7196,98,168,70,7,56,71
7197,495,192,-303,46,683,698
7198,350,445,95,10,81,96
7199,622,168,-454,36,532,547
7200,507,811,304,20,290,305
7201,292,847,555,38,541,556
7202,375,596,221,17,207,222
7203,280,224,-56,60,930,945
7204,218,463,245,18,231,246
7205,748,38,-710,20,276,291
7206,762,986,224,15,210,225
7207,121,648,527,37,513,528
7208,479,133,-346,44,640,655
7209,567,110,-457,38,529,544
7210,587,667,80,6,66,81
7211,286,12,-274,48,712,727
7212,432,768,336,22,322,337
7213,26,709,683,46,669,684
7214,681,156,-525,33,461,476
7215,48,855,807,54,793,808
7216,515,301,-214,51,772,787
7217,191,199,8,2,2,9
7218,349,473,124,10,110,125
7219,222,625,403,28,389,404
7220,827,844,17,3,3,18
7221,664,947,283,21,269,284
7222,976,756,-220,51,766,781
7223,769,212,-557,31,429,444
7224,794,990,196,14,182,197
7225,776,307,-469,36,517,532
7226,985,231,-754,18,232,247
7227,778,221,-557,31,429,444
7228,829,136,-693,22,293,308
7229,20,449,429,30,415,430
7230,970,716,-254,49,732,747
7231,640,366,-274,48,712,727
7232,598,234,-364,42,622,637
7233,755,523,-232,49,754,769
7234,96,856,760,49,746,761
7235,397,819,422,29,408,423
7236,290,342,52,5,38,53
7237,27,671,644,42,630,645
7238,145,412,267,20,253,268
7239,311,805,494,34,480,495
7240,568,448,-120,56,866,881
7241,368,962,594,39,580,595
7242,337,194,-143,56,843,858
7243,265,389,124,10,110,125
7244,735,543,-192,52,794,809
7245,651,249,-402,40,584,599
7246,364,361,-3,65,983,998
7247,423,702,279,21,265,280
7248,163,380,217,16,203,218
7249,483,396,-87,59,899,914
7250,874,10,-864,10,122,137
7251,149,469,320,21,306,321
7252,7,906,899,59,885,900
7253,601,996,395,28,381,396
7254,99,660,561,37,547,562
7255,316,540,224,15,210,225
7256,668,717,49,5,35,50
7257,287,76,-211,52,775,790
7258,90,912,822,54,808,823
7259,982,519,-463,36,523,538
7260,82,182,100,8,86,101
7261,516,799,283,21,269,284
7262,764,74,-690,22,296,311
7263,65,125,60,6,46,61
7264,586,84,-502,33,484,499
7265,606,77,-529,33,457,472
7266,75,847,772,50,758,773
7267,518,433,-85,60,901,916
7268,732,67,-665,25,321,336
7269,947,506,-441,39,545,560
7270,509,944,435,30,421,436
7271,333,328,-5,65,981,996
7272,350,175,-175,54,811,826
7273,889,173,-716,20,270,285
7274,636,619,-17,65,969,984
7275,384,347,-37,63,949,964
7276,811,471,-340,43,646,661
7277,37,708,671,46,657,672
7278,761,633,-128,56,858,873
7279,1,47,46,6,32,47
7280,347,739,392,26,378,393
7281,648,284,-364,42,622,637
7282,710,534,-176,53,810,825
7283,666,476,-190,53,796,811
7284,722,815,93,9,79,94
7285,161,200,39,6,25,40
7286,212,252,40,4,26,41
7287,10,938,928,59,914,929
7288,793,749,-44,62,942,957
7289,440,686,246,18,232,247
7290,564,845,281,20,267,282
7291,431,295,-136,55,850,865
7292,561,654,93,9,79,94
7293,921,838,-83,60,903,918
7294,861,414,-447,37,539,554
7295,406,866,460,31,446,461
7296,708,178,-530,32,456,471
7297,751,843,92,8,78,93
7298,320,445,125,11,111,126
7299,463,420,-43,63,943,958
7300,623,43,-580,28,406,421
7301,708,342,-366,42,620,635
7302,861,716,-145,57,841,856
7303,492,627,135,12,121,136
7304,99,255,156,12,142,157
7305,441,541,100,8,86,101
7306,630,422,-208,51,778,793
7307,532,43,-489,36,497,512
7308,753,633,-120,56,866,881
7309,950,954,4,2,2,5
7310,521,600,79,9,65,80
7311,217,761,544,35,530,545
7312,533,515,-18,64,968,983
7313,102,772,670,45,656,671
7314,672,807,135,12,121,136
7315,52,965,913,59,899,914
7316,822,898,76,7,62,77
7317,15,406,391,28,377,392
7318,501,868,367,27,353,368
7319,319,78,-241,51,745,760
7320,534,596,62,7,48,63
7321,365,233,-132,56,854,869
7322,843,601,-242,50,744,759
7323,721,618,-103,58,883,898
7324,480,821,341,24,327,342
7325,25,380,355,25,341,356
7326,152,138,-14,64,972,987
7327,296,789,493,34,479,494
7328,999,18,-981,4,5,20
7329,272,206,-66,61,920,935
7330,339,398,59,7,45,60
7331,249,329,80,6,66,81
7332,182,113,-69,61,917,932
7333,977,292,-685,23,301,316
7334,311,572,261,19,247,262
7335,88,760,672,43,658,673
7336,143,283,140,11,126,141
7337,496,878,382,27,368,383
7338,786,193,-593,29,393,408
7339,952,742,-210,52,776,791
7340,720,236,-484,34,502,517
7341,85,981,896,57,882,897
7342,736,651,-85,60,901,916
7343,544,270,-274,48,712,727
7344,63,66,3,3,3,4
7345,914,44,-870,10,116,131
7346,250,160,-90,60,896,911
7347,243,965,722,47,708,723
7348,406,884,478,33,464,479
7349,555,267,-288,46,698,713
7350,592,178,-414,39,572,587
7351,751,39,-712,19,274,289
7352,824,780,-44,62,942,957
7353,243,494,251,19,237,252
7354,743,467,-276,47,710,725
7355,145,372,227,17,213,228
7356,545,852,307,22,293,308
7357,595,700,105,9,91,106
7358,915,701,-214,51,772,787
7359,102,197,95,10,81,96
7360,728,684,-44,62,942,957
7361,345,212,-133,57,853,868
7362,330,123,-207,52,779,794
7363,108,448,340,23,326,341
7364,239,88,-151,55,835,850
7365,752,923,171,14,157,172
7366,836,429,-407,39,579,594
7367,9,392,383,28,369,384
7368,208,285,77,8,63,78
7369,130,119,-11,65,975,990
7370,208,400,192,13,178,193
7371,954,670,-284,47,702,717
7372,722,633,-89,61,897,912
7373,532,31,-501,34,485,500
7374,18,560,542,37,528,543
7375,44,359,315,23,301,316
7376,979,536,-443,38,543,558
7377,509,269,-240,49,746,761
7378,317,188,-129,58,857,872
7379,669,321,-348,43,638,653
7380,47,720,673,44,659,674
7381,637,115,-522,33,464,479
7382,893,71,-822,13,164,179
7383,923,538,-385,42,601,616
7384,147,14,-133,57,853,868
7385,0,426,426,29,412,427
7386,591,64,-527,32,459,474
7387,674,938,264,18,250,265
7388,470,943,473,32,459,474
7389,88,984,896,57,882,897
7390,318,172,-146,56,840,855
7391,319,999,680,44,666,681
7392,294,11,-283,48,703,718
7393,696,105,-591,28,395,410
7394,773,460,-313,47,673,688
7395,362,977,615,42,601,616
7396,224,603,379,27,365,380
7397,677,15,-662,23,324,339
7398,630,211,-419,39,567,582
7399,186,440,254,19,240,255
7400,876,830,-46,62,940,955
7401,373,737,364,25,350,365
7402,411,852,441,30,427,442
7403,417,26,-391,40,595,610
7404,685,937,252,18,238,253
7405,521,3,-518,32,468,483
7406,422,149,-273,49,713,728
7407,385,141,-244,49,742,757
7408,774,832,58,6,44,59
7409,14,750,736,47,722,737
7410,773,350,-423,38,563,578
7411,722,623,-99,59,887,902
7412,910,377,-533,32,453,468
7413,266,787,521,35,507,522
7414,980,112,-868,10,118,133
7415,850,637,-213,52,773,788
7416,523,134,-389,41,597,612
7417,635,102,-533,32,453,468
7418,687,848,161,12,147,162
7419,43,914,871,58,857,872
7420,11,447,436,29,422,437
7421,88,43,-45,63,941,956
7422,818,528,-290,47,696,711
7423,1,479,478,33,464,479
7424,501,519,18,3,4,19
7425,379,370,-9,66,977,992
7426,712,452,-260,48,726,741
7427,434,852,418,28,404,419
7428,975,492,-483,35,503,518
7429,118,501,383,28,369,384
7430,302,829,527,37,513,528
7431,858,913,55,7,41,56
7432,543,689,146,11,132,147
7433,926,932,6,3,4,7
7434,31,121,90,8,76,91
7435,495,32,-463,36,523,538
7436,476,810,334,24,320,335
7437,874,994,120,9,106,121
7438,764,330,-434,38,552,567
7439,884,214,-670,23,316,331
7440,947,196,-751,18,235,250
7441,519,105,-414,39,572,587
7442,415,987,572,38,558,573
7443,968,36,-932,6,54,69
7444,311,595,284,20,270,285
7445,145,795,650,43,636,651
7446,197,847,650,43,636,651
7447,34,191,157,13,143,158
7448,919,825,-94,59,892,907
7449,988,409,-579,29,407,422
7450,665,602,-63,61,923,938
7451,29,974,945,61,931,946
7452,348,377,29,5,15,30
7453,816,267,-549,31,437,452
7454,789,727,-62,61,924,939
7455,857,78,-779,17,207,222
7456,952,495,-457,38,529,544
7457,567,908,341,24,327,342
7458,115,880,765,51,751,766
7459,916,660,-256,48,730,745
7460,526,183,-343,43,643,658
7461,616,295,-321,46,665,680
7462,272,642,370,25,356,371
7463,373,798,425,29,411,426
7464,993,530,-463,36,523,538
7465,194,652,458,31,444,459
7466,848,588,-260,48,726,741
7467,983,744,-239,50,747,762
7468,101,131,30,5,16,31
7469,638,292,-346,44,640,655
7470,605,142,-463,36,523,538
7471,830,415,-415,39,571,586
7472,753,776,23,5,9,24
7473,288,492,204,15,190,205
7474,39,44,5,3,3,6
7475,803,979,176,12,162,177
7476,810,707,-103,58,883,898
7477,537,220,-317,46,669,684
7478,111,291,180,13,166,181
7479,848,505,-343,43,643,658
7480,125,441,316,22,302,317
7481,152,897,745,49,731,746
7482,487,802,315,23,301,316
7483,722,578,-144,55,842,857
7484,394,453,59,7,45,60
7485,12,587,575,40,561,576
7486,373,365,-8,63,978,993
7487,345,98,-247,49,739,754
7488,726,419,-307,46,679,694
7489,838,307,-531,32,455,470
7490,462,458,-4,64,982,997
7491,724,943,219,17,205,220
7492,683,925,242,17,228,243
7493,838,26,-812,14,174,189
7494,498,18,-480,34,506,521
7495,710,261,-449,38,537,552
7496,520,110,-410,40,576,591
7497,101,115,14,4,8,15
7498,874,430,-444,37,542,557
7499,320,159,-161,56,825,840
7500,791,683,-108,58,878,893
7501,230,321,91,9,77,92
7502,261,943,682,45,668,683
7503,763,43,-720,19,266,281
7504,908,368,-540,31,446,461
7505,276,577,301,22,287,302
7506,927,367,-560,29,426,441
7507,497,490,-7,64,979,994
7508,614,865,251,19,237,252
7509,527,41,-486,34,500,515
7510,157,113,-44,62,942,957
7511,907,519,-388,40,598,613
7512,750,671,-79,60,907,922
7513,324,65,-259,49,727,742
7514,998,60,-938,7,48,63
7515,691,492,-199,52,787,802
7516,935,105,-830,13,156,171
7517,490,872,382,27,368,383
7518,757,884,127,12,113,128
7519,881,196,-685,23,301,316
7520,366,658,292,20,278,293
7521,338,290,-48,61,938,953
7522,492,821,329,23,315,330
7523,185,989,804,52,790,805
7524,850,4,-846,12,140,155
7525,905,680,-225,52,761,776
7526,232,799,567,39,553,568
7527,620,294,-326,44,660,675
7528,325,228,-97,60,889,904
7529,260,251,-9,66,977,992
7530,916,501,-415,39,571,586
7531,53,220,167,14,153,168
7532,13,499,486,33,472,487
7533,155,396,241,17,227,242
7534,489,664,175,15,161,176
7535,525,75,-450,37,536,551
7536,400,755,355,25,341,356
7537,313,859,546,36,532,547
7538,962,751,-211,52,775,790
7539,54,551,497,33,483,498
7540,789,133,-656,23,330,345
7541,56,901,845,56,831,846
7542,497,714,217,16,203,218
7543,602,680,78,8,64,79
7544,969,196,-773,17,213,228
7545,832,269,-563,30,423,438
7546,411,773,362,25,348,363
7547,874,716,-158,55,828,843
7548,2,678,676,44,662,677
7549,353,844,491,34,477,492
7550,270,573,303,23,289,304
7551,965,46,-919,7,67,82
7552,52,699,647,44,633,648
7553,800,482,-318,45,668,683
7554,493,477,-16,63,970,985
7555,388,245,-143,56,843,858
7556,172,691,519,36,505,520
7557,961,930,-31,63,955,970
7558,795,975,180,13,166,181
7559,581,536,-45,63,941,956
7560,344,565,221,17,207,222
7561,968,41,-927,7,59,74
7562,721,647,-74,61,912,927
7563,106,735,629,42,615,630
7564,653,49,-604,27,382,397
7565,105,664,559,39,545,560
7566,207,759,552,36,538,553
7567,32,819,787,52,773,788
7568,406,888,482,32,468,483
7569,854,15,-839,12,147,162
7570,984,970,-14,64,972,987
7571,792,288,-504,32,482,497
7572,391,382,-9,66,977,992
7573,880,510,-370,42,616,631
7574,425,840,415,30,401,416
7575,703,676,-27,64,959,974
7576,71,3,-68,60,918,933
7577,778,305,-473,37,513,528
7578,857,98,-759,17,227,242
7579,989,530,-459,37,527,542
7580,616,988,372,25,358,373
7581,549,879,330,23,316,331
7582,803,295,-508,33,478,493
7583,324,319,-5,65,981,996
7584,282,614,332,23,318,333
7585,711,739,28,4,14,29
7586,537,191,-346,44,640,655
7587,789,636,-153,57,833,848
7588,625,708,83,8,69,84
7589,744,880,136,10,122,137
7590,620,470,-150,55,836,851
7591,383,545,162,12,148,163
7592,166,805,639,44,625,640
7593,827,418,-409,41,577,592
7594,987,927,-60,61,926,941
7595,850,578,-272,47,714,729
7596,718,385,-333,45,653,668
7597,946,971,25,4,11,26
7598,433,451,18,3,4,19
7599,434,454,20,3,6,21
7600,792,948,156,12,142,157
7601,344,615,271,21,257,272
7602,36,648,612,40,598,613
7603,513,907,394,27,380,395
7604,401,706,305,21,291,306
7605,413,725,312,21,298,313
7606,291,104,-187,54,799,814
7607,508,307,-201,54,785,800
7608,42,787,745,49,731,746
7609,256,849,593,39,579,594
7610,85,80,-5,65,981,996
7611,447,572,125,11,111,126
7612,869,880,11,4,5,12
7613,788,194,-594,28,392,407
7614,688,89,-599,27,387,402
7615,910,407,-503,33,483,498
7616,132,328,196,14,182,197
7617,470,653,183,15,169,184
7618,93,37,-56,60,930,945
7619,114,899,785,51,771,786
7620,414,694,280,19,266,281
7621,884,222,-662,23,324,339
7622,2,430,428,29,414,429
7623,962,193,-769,18,217,232
7624,449,638,189,15,175,190
7625,396,835,439,31,425,440
7626,345,720,375,27,361,376
7627,3,909,906,59,892,907
7628,202,551,349,25,335,350
7629,658,237,-421,39,565,580
7630,968,73,-895,9,91,106
7631,200,932,732,48,718,733
7632,397,794,397,28,383,398
7633,942,908,-34,63,952,967
7634,34,0,-34,63,952,967
7635,215,313,98,8,84,99
7636,823,179,-644,24,342,357
7637,10,440,430,30,416,431
7638,99,783,684,45,670,685
7639,131,595,464,30,450,465
7640,991,117,-874,11,112,127
7641,507,310,-197,53,789,804
7642,227,190,-37,63,949,964
7643,721,759,38,5,24,39
7644,80,750,670,45,656,671
7645,975,93,-882,10,104,119
7646,93,745,652,43,638,653
7647,314,177,-137,58,849,864
7648,191,83,-108,58,878,893
7649,881,386,-495,34,491,506
7650,985,947,-38,62,948,963
7651,569,244,-325,45,661,676
7652,524,342,-182,53,804,819
7653,14,219,205,16,191,206
7654,306,121,-185,55,801,816
7655,511,25,-486,34,500,515
7656,202,349,147,12,133,148
7657,526,319,-207,52,779,794
7658,750,881,131,11,117,132
7659,524,526,2,2,2,3
7660,634,511,-123,58,863,878
7661,494,187,-307,46,679,694
7662,925,375,-550,30,436,451
7663,110,850,740,48,726,741
7664,462,550,88,7,74,89
7665,226,875,649,43,635,650
7666,596,771,175,15,161,176
7667,307,926,619,42,605,620
7668,487,463,-24,62,962,977
7669,933,745,-188,53,798,813
7670,449,834,385,26,371,386
7671,226,48,-178,54,808,823
7672,940,995,55,7,41,56
7673,920,407,-513,34,473,488
7674,768,530,-238,50,748,763
7675,952,730,-222,51,764,779
7676,286,885,599,41,585,600
7677,10,478,468,31,454,469
7678,514,189,-325,45,661,676
7679,834,288,-546,31,440,455
7680,154,512,358,25,344,359
7681,263,452,189,15,175,190
7682,792,323,-469,36,517,532
7683,216,797,581,39,567,582
7684,349,202,-147,56,839,854
7685,789,176,-613,27,373,388
7686,409,234,-175,54,811,826
7687,712,919,207,17,193,208
7688,121,34,-87,59,899,914
7689,231,890,659,44,645,660
7690,774,147,-627,26,359,374
7691,346,80,-266,49,720,735
7692,194,210,16,2,2,17
7693,360,80,-280,46,706,721
7694,31,783,752,48,738,753
7695,340,546,206,16,192,207
7696,472,28,-444,37,542,557
7697,628,749,121,10,107,122
7698,340,195,-145,57,841,856
7699,790,596,-194,53,792,807
7700,370,662,292,20,278,293
7701,503,354,-149,56,837,852
7702,65,149,84,7,70,85
7703,624,904,280,19,266,281
7704,562,978,416,27,402,417
7705,850,225,-625,27,361,376
7706,242,570,328,22,314,329
7707,914,190,-724,19,262,277
7708,554,855,301,22,287,302
7709,572,861,289,20,275,290
7710,459,895,436,29,422,437
7711,990,845,-145,57,841,856
7712,868,39,-829,14,157,172
7713,615,884,269,20,255,270
7714,840,750,-90,60,896,911
7715,589,216,-373,42,613,628
7716,505,684,179,14,165,180
7717,942,883,-59,62,927,942
7718,46,414,368,24,354,369
7719,890,5,-885,10,101,116
7720,810,110,-700,21,286,301
7721,239,613,374,26,360,375
7722,905,270,-635,26,351,366
7723,259,926,667,45,653,668
7724,813,45,-768,16,218,233
7725,87,39,-48,61,938,953
7726,653,446,-207,52,779,794
7727,408,611,203,16,189,204
7728,689,686,-3,65,983,998
7729,461,400,-61,62,925,940
7730,185,914,729,48,715,730
7731,888,849,-39,62,947,962
7732,721,365,-356,42,630,645
7733,890,686,-204,52,782,797
7734,980,290,-690,22,296,311
7735,211,697,486,33,472,487
7736,56,563,507,35,493,508
7737,560,121,-439,37,547,562
7738,935,327,-608,26,378,393
7739,341,785,444,30,430,445
7740,473,6,-467,36,519,534
7741,248,524,276,19,262,277
7742,809,383,-426,39,560,575
7743,543,993,450,30,436,451
7744,91,621,530,35,516,531
7745,955,645,-310,45,676,691
7746,822,649,-173,55,813,828
7747,347,162,-185,55,801,816
7748,976,706,-270,48,716,731
7749,368,778,410,28,396,411
7750,489,774,285,21,271,286
7751,363,360,-3,65,983,998
7752,975,901,-74,61,912,927
7753,304,86,-218,52,768,783
7754,116,474,358,25,344,359
7755,99,948,849,55,835,850
7756,212,401,189,15,175,190
7757,572,51,-521,34,465,480
7758,660,21,-639,25,347,362
7759,910,977,67,7,53,68
7760,553,317,-236,50,750,765
7761,771,263,-508,33,478,493
7762,554,699,145,11,131,146
7763,132,720,588,39,574,589
7764,524,393,-131,57,855,870
7765,246,619,373,26,359,374
7766,414,554,140,11,126,141
7767,708,961,253,19,239,254
7768,868,433,-435,38,551,566
7769,923,186,-737,20,249,264
7770,480,65,-415,39,571,586
7771,58,513,455,32,441,456
7772,251,49,-202,53,784,799
7773,313,660,347,25,333,348
7774,238,834,596,39,582,597
7775,177,172,-5,65,981,996
7776,618,234,-384,40,602,617
7777,29,848,819,54,805,820
7778,754,905,151,13,137,152
7779,239,995,756,49,742,757
7780,494,231,-263,48,723,738
7781,916,920,4,2,2,5
7782,803,208,-595,28,391,406
7783,390,48,-342,43,644,659
7784,291,36,-255,49,731,746
7785,30,908,878,58,864,879
7786,373,773,400,26,386,401
7787,717,271,-446,37,540,555
7788,156,155,-1,66,985,1000
7789,733,939,206,16,192,207
7790,682,385,-297,48,689,704
7791,447,375,-72,59,914,929
7792,492,168,-324,44,662,677
7793,40,245,205,16,191,206
7794,821,470,-351,43,635,650
7795,985,69,-916,7,70,85
7796,777,480,-297,48,689,704
7797,316,723,407,29,393,408
7798,434,44,-390,40,596,611
7799,179,973,794,52,780,795
7800,538,45,-493,35,493,508
7801,24,891,867,57,853,868
7802,551,87,-464,35,522,537
7803,870,382,-488,33,498,513
7804,172,40,-132,56,854,869
7805,878,732,-146,56,840,855
7806,142,446,304,20,290,305
7807,929,177,-752,17,234,249
7808,681,234,-447,37,539,554
7809,619,392,-227,51,759,774
7810,121,663,542,37,528,543
7811,378,336,-42,63,944,959
7812,581,269,-312,44,674,689
7813,201,715,514,34,500,515
7814,181,244,63,8,49,64
7815,757,564,-193,54,793,808
7816,650,874,224,15,210,225
7817,911,242,-669,24,317,332
7818,542,500,-42,63,944,959
7819,305,132,-173,55,813,828
7820,352,729,377,26,363,378
7821,400,266,-134,56,852,867
7822,456,205,-251,50,735,750
7823,347,440,93,9,79,94
7824,958,911,-47,62,939,954
7825,321,145,-176,53,810,825
7826,787,581,-206,52,780,795
7827,500,791,291,21,277,292
7828,359,266,-93,60,893,908
7829,586,802,216,15,202,217
7830,617,364,-253,50,733,748
7831,151,459,308,21,294,309
7832,41,145,104,8,90,105
7833,197,583,386,26,372,387
7834,820,41,-779,17,207,222
7835,16,241,225,16,211,226
7836,620,557,-63,61,923,938
7837,838,842,4,2,2,5
7838,41,823,782,52,768,783
7839,436,77,-359,42,627,642
7840,287,886,599,41,585,600
7841,537,861,324,22,310,325
7842,500,296,-204,52,782,797
7843,997,384,-613,27,373,388
7844,992,63,-929,8,57,72
7845,171,920,749,50,735,750
7846,813,423,-390,40,596,611
7847,295,174,-121,59,865,880
7848,873,986,113,9,99,114
7849,587,822,235,18,221,236
7850,777,798,21,4,7,22
7851,964,359,-605,28,381,396
7852,903,547,-356,42,630,645
7853,255,492,237,18,223,238
7854,325,940,615,42,601,616
7855,905,805,-100,58,886,901
7856,606,803,197,15,183,198
7857,703,486,-217,53,769,784
7858,101,39,-62,61,924,939
7859,363,493,130,10,116,131
7860,715,308,-407,39,579,594
7861,12,328,316,22,302,317
7862,694,171,-523,33,463,478
7863,163,396,233,17,219,234
7864,492,851,359,26,345,360
7865,516,855,339,24,325,340
7866,496,860,364,25,350,365
7867,745,957,212,15,198,213
7868,275,596,321,22,307,322
7869,202,767,565,38,551,566
7870,446,433,-13,65,973,988
7871,623,30,-593,29,393,408
7872,251,464,213,16,199,214
7873,982,133,-849,13,137,152
7874,267,950,683,46,669,684
7875,249,35,-214,51,772,787
7876,5,902,897,58,883,898
7877,954,247,-707,21,279,294
7878,401,531,130,10,116,131
7879,726,868,142,12,128,143
7880,214,120,-94,59,892,907
7881,782,452,-330,45,656,671
7882,839,974,135,12,121,136
7883,507,517,10,3,4,11
7884,353,350,-3,65,983,998
7885,761,972,211,16,197,212
7886,842,756,-86,59,900,915
7887,674,3,-671,23,315,330
7888,312,714,402,27,388,403
7889,173,599,426,29,412,427
7890,341,751,410,28,396,411
7891,606,339,-267,49,719,734
7892,403,711,308,21,294,309
7893,452,916,464,30,450,465
7894,70,64,-6,64,980,995
7895,898,120,-778,17,208,223
7896,605,656,51,6,37,52
7897,718,952,234,17,220,235
7898,846,42,-804,14,182,197
7899,964,767,-197,53,789,804
7900,504,433,-71,60,915,930
7901,967,723,-244,49,742,757
7902,179,7,-172,54,814,829
7903,628,688,60,6,46,61
7904,294,623,329,23,315,330
7905,126,941,815,55,801,816
7906,108,524,416,27,402,417
7907,219,206,-13,65,973,988
7908,363,9,-354,43,632,647
7909,961,760,-201,54,785,800
7910,968,386,-582,28,404,419
7911,889,335,-554,31,432,447
7912,501,627,126,11,112,127
7913,76,785,709,47,695,710
7914,773,222,-551,30,435,450
7915,189,444,255,20,241,256
7916,491,458,-33,64,953,968
7917,1,735,734,49,720,735
7918,861,630,-231,50,755,770
7919,508,682,174,14,160,175
7920,834,522,-312,44,674,689
7921,864,590,-274,48,712,727
7922,928,723,-205,53,781,796
7923,656,276,-380,41,606,621
7924,113,441,328,22,314,329
7925,625,57,-568,28,418,433
7926,452,562,110,10,96,111
7927,527,266,-261,49,725,740
7928,821,879,58,6,44,59
7929,831,598,-233,52,753,768
7930,382,674,292,20,278,293
7931,152,693,541,37,527,542
7932,914,545,-369,43,617,632
7933,852,532,-320,44,666,681
7934,524,495,-29,64,957,972
7935,350,783,433,29,419,434
7936,255,507,252,18,238,253
7937,345,72,-273,49,713,728
7938,595,375,-220,51,766,781
7939,204,342,138,11,124,139
7940,705,817,112,8,98,113
7941,137,650,513,34,499,514
7942,646,834,188,14,174,189
7943,427,52,-375,41,611,626
7944,227,910,683,46,669,684
7945,431,483,52,5,38,53
7946,976,964,-12,64,974,989
7947,416,216,-200,51,786,801
7948,778,770,-8,63,978,993
7949,741,150,-591,28,395,410
7950,500,465,-35,63,951,966
7951,708,505,-203,53,783,798
7952,752,984,232,16,218,233
7953,788,322,-466,36,520,535
7954,90,626,536,35,522,537
7955,452,99,-353,44,633,648
7956,829,630,-199,52,787,802
7957,263,997,734,49,720,735
7958,752,779,27,5,13,28
7959,192,82,-110,58,876,891
7960,522,576,54,6,40,55
7961,860,338,-522,33,464,479
7962,927,109,-818,14,168,183
7963,289,566,277,20,263,278
7964,33,626,593,39,579,594
7965,930,766,-164,54,822,837
7966,490,830,340,23,326,341
7967,777,403,-374,41,612,627
7968,557,704,147,12,133,148
7969,393,895,502,34,488,503
7970,197,973,776,50,762,777
7971,896,266,-630,25,356,371
7972,372,874,502,34,488,503
7973,650,703,53,6,39,54
7974,694,114,-580,28,406,421
7975,314,259,-55,61,931,946
7976,848,154,-694,21,292,307
7977,765,206,-559,30,427,442
7978,83,129,46,6,32,47
7979,906,447,-459,37,527,542
7980,659,154,-505,35,481,496
7981,669,228,-441,39,545,560
7982,810,240,-570,30,416,431
7983,554,298,-256,48,730,745
7984,457,446,-11,65,975,990
7985,247,709,462,32,448,463
7986,639,385,-254,49,732,747
7987,159,708,549,37,535,550
7988,944,946,2,2,2,3
7989,186,885,699,47,685,700
7990,716,80,-636,25,350,365
7991,621,524,-97,60,889,904
7992,379,615,236,17,222,237
7993,802,652,-150,55,836,851
7994,766,118,-648,23,338,353
7995,820,54,-766,17,220,235
7996,298,623,325,23,311,326
7997,683,102,-581,29,405,420
7998,527,270,-257,50,729,744
7999,719,274,-445,38,541,556
8000,68,339,271,21,257,272
8001,287,972,685,46,671,686
8002,317,724,407,29,393,408
8003,370,49,-321,46,665,680
8004,332,629,297,21,283,298
8005,987,138,-849,13,137,152
8006,726,67,-659,24,327,342
8007,323,430,107,10,93,108
8008,28,433,405,28,391,406
8009,893,635,-258,49,728,743
8010,676,713,37,5,23,38
8011,811,621,-190,53,796,811
8012,851,135,-716,20,270,285
8013,854,920,66,6,52,67
8014,468,407,-61,62,925,940
8015,892,996,104,8,90,105
8016,107,927,820,53,806,821
8017,811,724,-87,59,899,914
8018,95,761,666,44,652,667
8019,966,899,-67,61,919,934
8020,826,960,134,11,120,135
8021,173,438,265,19,251,266
8022,288,696,408,27,394,409
8023,915,121,-794,16,192,207
8024,509,313,-196,52,790,805
8025,142,37,-105,60,881,896
8026,198,512,314,22,300,315
8027,736,147,-589,29,397,412
8028,125,194,69,7,55,70
8029,851,627,-224,50,762,777
8030,471,560,89,8,75,90
8031,218,697,479,34,465,480
8032,824,130,-694,21,292,307
8033,819,73,-746,19,240,255
8034,253,470,217,16,203,218
8035,486,310,-176,53,810,825
8036,784,119,-665,25,321,336
8037,736,246,-490,35,496,511
8038,974,696,-278,47,708,723
8039,694,486,-208,51,778,793
8040,789,215,-574,29,412,427
8041,532,304,-228,50,758,773
8042,667,556,-111,58,875,890
8043,154,140,-14,64,972,987
8044,337,676,339,24,325,340
8045,379,660,281,20,267,282
8046,438,16,-422,38,564,579
8047,498,309,-189,54,797,812
8048,905,921,16,2,2,17
8049,22,719,697,46,683,698
8050,673,853,180,13,166,181
8051,405,296,-109,59,877,892
8052,328,431,103,10,89,104
8053,379,629,250,18,236,251
8054,559,59,-500,33,486,501
8055,980,924,-56,60,930,945
8056,559,708,149,12,135,150
8057,112,170,58,6,44,59
8058,119,291,172,13,158,173
8059,342,846,504,33,490,505
8060,464,360,-104,57,882,897
8061,891,212,-679,22,307,322
8062,657,10,-647,24,339,354
8063,347,827,480,31,466,481
8064,185,400,215,17,201,216
8065,982,33,-949,6,37,52
8066,320,997,677,45,663,678
8067,560,131,-429,39,557,572
8068,742,422,-320,44,666,681
8069,956,174,-782,16,204,219
8070,112,438,326,23,312,327
8071,271,914,643,43,629,644
8072,710,344,-366,42,620,635
8073,807,655,-152,54,834,849
8074,372,908,536,35,522,537
8075,483,685,202,15,188,203
8076,304,290,-14,64,972,987
8077,572,507,-65,62,921,936
8078,560,449,-111,58,875,890
8079,837,44,-793,17,193,208
8080,303,469,166,13,152,167
8081,577,590,13,4,7,14
8082,262,513,251,19,237,252
8083,718,949,231,18,217,232
8084,586,549,-37,63,949,964
8085,475,482,7,4,5,8
8086,728,747,19,4,5,20
8087,958,29,-929,8,57,72
8088,635,155,-480,34,506,521
8089,72,274,202,15,188,203
8090,278,401,123,11,109,124
8091,238,121,-117,58,869,884
8092,263,515,252,18,238,253
8093,20,481,461,32,447,462
8094,442,335,-107,59,879,894
8095,432,587,155,13,141,156
8096,347,284,-63,61,923,938
8097,110,88,-22,63,964,979
8098,649,823,174,14,160,175
8099,116,445,329,23,315,330
8100,527,549,22,4,8,23
8101,246,539,293,21,279,294
8102,246,203,-43,63,943,958
8103,871,206,-665,25,321,336
8104,233,149,-84,59,902,917
8105,628,815,187,15,173,188
8106,687,798,111,11,97,112
8107,519,628,109,10,95,110
8108,23,331,308,21,294,309
8109,625,30,-595,28,391,406
8110,46,225,179,14,165,180
8111,105,934,829,55,815,830
8112,600,402,-198,52,788,803
8113,926,851,-75,61,911,926
8114,532,602,70,7,56,71
8115,411,385,-26,64,960,975
8116,589,718,129,10,115,130
8117,331,468,137,11,123,138
8118,541,437,-104,57,882,897
8119,493,763,270,20,256,271
8120,391,649,258,18,244,259
8121,70,788,718,48,704,719
8122,582,515,-67,61,919,934
8123,385,294,-91,60,895,910
8124,558,436,-122,58,864,879
8125,240,363,123,11,109,124
8126,878,2,-876,10,110,125
8127,419,630,211,16,197,212
8128,90,653,563,38,549,564
8129,805,730,-75,61,911,926
8130,1,89,88,7,74,89
8131,852,887,35,5,21,36
8132,246,658,412,28,398,413
8133,425,694,269,20,255,270
8134,280,486,206,16,192,207
8135,732,793,61,7,47,62
8136,153,131,-22,63,964,979
8137,597,99,-498,34,488,503
8138,970,408,-562,30,424,439
8139,977,142,-835,13,151,166
8140,528,500,-28,63,958,973
8141,897,909,12,3,6,13
8142,506,565,59,7,45,60
8143,71,163,92,8,78,93
8144,154,611,457,31,443,458
8145,981,286,-695,21,291,306
8146,978,371,-607,27,379,394
8147,553,465,-88,58,898,913
8148,863,629,-234,51,752,767
8149,903,244,-659,24,327,342
8150,418,768,350,25,336,351
8151,383,236,-147,56,839,854
8152,75,389,314,22,300,315
8153,156,662,506,34,492,507
8154,214,385,171,14,157,172
8155,623,601,-22,63,964,979
8156,806,350,-456,35,530,545
8157,378,165,-213,52,773,788
8158,632,853,221,17,207,222
8159,396,365,-31,63,955,970
8160,692,868,176,12,162,177
8161,865,554,-311,45,675,690
8162,989,64,-925,8,61,76
8163,829,530,-299,47,687,702
8164,423,781,358,25,344,359
8165,157,357,200,14,186,201
8166,712,246,-466,36,520,535
8167,355,813,458,31,444,459
8168,311,651,340,23,326,341
8169,131,445,314,22,300,315
8170,985,587,-398,40,588,603
8171,689,216,-473,37,513,528
8172,988,276,-712,19,274,289
8173,514,110,-404,39,582,597
8174,22,798,776,50,762,777
8175,887,248,-639,25,347,362
8176,747,333,-414,39,572,587
8177,355,439,84,7,70,85
8178,806,888,82,7,68,83
8179,669,428,-241,51,745,760
8180,735,979,244,17,230,245
8181,707,126,-581,29,405,420
8182,877,208,-669,24,317,332
8183,712,543,-169,56,817,832
8184,558,257,-301,47,685,700
8185,922,768,-154,56,832,847
8186,253,437,184,13,170,185
8187,919,946,27,5,13,28
8188,325,560,235,18,221,236
8189,459,333,-126,57,860,875
8190,557,615,58,6,44,59
8191,935,82,-853,12,133,148
8192,740,803,63,8,49,64
8193,702,924,222,17,208,223
8194,419,621,202,15,188,203
8195,757,149,-608,26,378,393
8196,857,833,-24,62,962,977
8197,576,800,224,15,210,225
8198,63,378,315,23,301,316
8199,494,931,437,30,423,438
8200,346,334,-12,64,974,989
8201,243,645,402,27,388,403
8202,5,300,295,22,281,296
8203,42,313,271,21,257,272
8204,830,437,-393,42,593,608
8205,408,580,172,13,158,173
8206,225,810,585,39,571,586
8207,526,82,-444,37,542,557
8208,973,8,-965,5,21,36
8209,818,409,-409,41,577,592
8210,729,843,114,9,100,115
8211,857,472,-385,42,601,616
8212,976,507,-469,36,517,532
8213,980,749,-231,50,755,770
8214,118,136,18,3,4,19
8215,611,227,-384,40,602,617
8216,532,143,-389,41,597,612
8217,419,453,34,4,20,35
8218,51,811,760,49,746,761
8219,43,427,384,25,370,385
8220,986,781,-205,53,781,796
8221,575,109,-466,36,520,535
8222,828,652,-176,53,810,825
8223,627,171,-456,35,530,545
8224,407,356,-51,62,935,950
8225,370,717,347,25,333,348
8226,463,48,-415,39,571,586
8227,369,277,-92,59,894,909
8228,571,836,265,19,251,266
8229,127,187,60,6,46,61
8230,61,500,439,31,425,440
8231,317,458,141,12,127,142
8232,863,509,-354,43,632,647
8233,791,101,-690,22,296,311
8234,138,905,767,52,753,768
8235,278,838,560,36,546,561
8236,247,832,585,39,571,586
8237,710,566,-144,55,842,857
8238,511,344,-167,54,819,834
8239,396,24,-372,41,614,629
8240,724,180,-544,30,442,457
8241,699,262,-437,38,549,564
8242,538,651,113,9,99,114
8243,5,428,423,30,409,424
8244,292,602,310,22,296,311
8245,136,523,387,27,373,388
8246,865,304,-561,31,425,440
8247,651,202,-449,38,537,552
8248,489,786,297,21,283,298
8249,896,474,-422,38,564,579
8250,882,576,-306,46,680,695
8251,812,17,-795,16,191,206
8252,312,833,521,35,507,522
8253,695,459,-236,50,750,765
8254,843,459,-384,40,602,617
8255,265,39,-226,51,760,775
8256,943,644,-299,47,687,702
8257,377,276,-101,59,885,900
8258,891,419,-472,34,514,529
8259,231,885,654,44,640,655
8260,988,223,-765,18,221,236
8261,680,843,163,13,149,164
8262,162,535,373,26,359,374
8263,940,481,-459,37,527,542
8264,141,581,440,29,426,441
8265,849,780,-69,61,917,932
8266,715,360,-355,43,631,646
8267,402,503,101,9,87,102
8268,449,72,-377,43,609,624
8269,842,74,-768,16,218,233
8270,288,931,643,43,629,644
8271,451,362,-89,61,897,912
8272,640,480,-160,54,826,841
8273,93,552,459,32,445,460
8274,755,705,-50,62,936,951
8275,410,938,528,34,514,529
8276,167,716,549,37,535,550
8277,320,726,406,28,392,407
8278,702,487,-215,51,771,786
8279,691,738,47,7,33,48
8280,498,727,229,17,215,230
8281,542,54,-488,33,498,513
8282,157,30,-127,57,859,874
8283,172,391,219,17,205,220
8284,417,373,-44,62,942,957
8285,285,566,281,20,267,282
8286,732,135,-597,28,389,404
8287,114,388,274,19,260,275
8288,948,193,-755,18,231,246
8289,393,473,80,6,66,81
8290,765,454,-311,45,675,690
8291,571,125,-446,37,540,555
8292,958,61,-897,10,89,104
8293,386,42,-344,42,642,657
8294,278,487,209,15,195,210
8295,88,519,431,31,417,432
8296,969,985,16,2,2,17
8297,158,111,-47,62,939,954
8298,308,91,-217,53,769,784
8299,74,686,612,40,598,613
8300,818,291,-527,32,459,474
8301,899,63,-836,12,150,165
8302,291,834,543,38,529,544
8303,684,528,-156,55,830,845
8304,335,431,96,7,82,97
8305,539,101,-438,37,548,563
8306,424,237,-187,54,799,814
8307,836,860,24,3,10,25
8308,104,497,393,27,379,394
8309,144,958,814,54,800,815
8310,86,696,610,40,596,611
8311,229,279,50,5,36,51
8312,272,436,164,12,150,165
8313,866,555,-311,45,675,690
8314,78,711,633,42,619,634
8315,690,809,119,11,105,120
8316,677,594,-83,60,903,918
8317,5,927,922,60,908,923
8318,464,168,-296,45,690,705
8319,933,874,-59,62,927,942
8320,489,458,-31,63,955,970
8321,625,755,130,10,116,131
8322,975,543,-432,37,554,569
8323,213,410,197,15,183,198
8324,691,517,-174,54,812,827
8325,5,395,390,27,376,391
8326,448,328,-120,56,866,881
8327,378,924,546,36,532,547
8328,329,790,461,32,447,462
8329,137,634,497,33,483,498
8330,583,262,-321,46,665,680
8331,959,566,-393,42,593,608
8332,257,859,602,40,588,603
8333,593,63,-530,32,456,471
8334,584,277,-307,46,679,694
8335,178,264,86,8,72,87
8336,114,500,386,26,372,387
8337,612,812,200,14,186,201
8338,639,46,-593,29,393,408
8339,299,440,141,12,127,142
8340,973,995,22,4,8,23
8341,247,49,-198,52,788,803
8342,99,142,43,6,29,44
8343,229,476,247,19,233,248
8344,85,12,-73,62,913,928
8345,275,735,460,31,446,461
8346,82,520,438,30,424,439
8347,790,958,168,12,154,169
8348,913,120,-793,17,193,208
8349,918,421,-497,35,489,504
8350,644,16,-628,25,358,373
8351,135,58,-77,61,909,924
8352,12,261,249,18,235,250
8353,590,288,-302,46,684,699
8354,699,417,-282,48,704,719
8355,789,473,-316,45,670,685
8356,73,815,742,49,728,743
8357,473,124,-349,44,637,652
8358,945,891,-54,61,932,947
8359,323,593,270,20,256,271
8360,761,163,-598,27,388,403
8361,448,324,-124,57,862,877
8362,850,63,-787,16,199,214
8363,237,969,732,48,718,733
8364,507,622,115,10,101,116
8365,712,88,-624,25,362,377
8366,703,518,-185,55,801,816
8367,347,932,585,39,571,586
8368,895,713,-182,53,804,819
8369,463,91,-372,41,614,629
8370,617,363,-254,49,732,747
8371,520,597,77,8,63,78
8372,876,358,-518,32,468,483
8373,634,938,304,20,290,305
8374,204,908,704,45,690,705
8375,322,771,449,30,435,450
8376,501,957,456,30,442,457
8377,292,574,282,20,268,283
8378,177,376,199,16,185,200
8379,909,179,-730,20,256,271
8380,367,223,-144,55,842,857
8381,785,595,-190,53,796,811
8382,924,651,-273,49,713,728
8383,923,325,-598,27,388,403
8384,16,21,5,3,3,6
8385,758,357,-401,41,585,600
8386,405,346,-59,62,927,942
8387,301,225,-76,60,910,925
8388,193,223,30,5,16,31
8389,578,753,175,15,161,176
8390,591,982,391,28,377,392
8391,809,977,168,12,154,169
8392,588,988,400,26,386,401
8393,574,859,285,21,271,286
8394,965,949,-16,63,970,985
8395,540,106,-434,38,552,567
8396,914,266,-648,23,338,353
8397,351,623,272,18,258,273
8398,215,177,-38,62,948,963
8399,113,435,322,22,308,323
8400,962,774,-188,53,798,813
8401,532,75,-457,38,529,544
8402,107,636,529,35,515,530
8403,738,72,-666,24,320,335
8404,649,48,-601,29,385,400
8405,6,896,890,58,876,891
8406,498,116,-382,41,604,619
8407,440,236,-204,52,782,797
8408,177,123,-54,61,932,947
8409,771,913,142,12,128,143
8410,925,85,-840,11,146,161
8411,378,516,138,11,124,139
8412,220,431,211,16,197,212
8413,406,479,73,7,59,74
8414,996,44,-952,4,34,49
8415,787,63,-724,19,262,277
8416,755,948,193,14,179,194
8417,839,407,-432,37,554,569
8418,488,372,-116,57,870,885
8419,335,164,-171,55,815,830
8420,441,613,172,13,158,173
8421,457,116,-341,44,645,660
8422,79,843,764,50,750,765
8423,337,126,-211,52,775,790
8424,381,444,63,8,49,64
8425,503,548,45,6,31,46
8426,679,41,-638,25,348,363
8427,684,284,-400,39,586,601
8428,692,520,-172,54,814,829
8429,549,153,-396,40,590,605
8430,64,366,302,22,288,303
8431,367,780,413,29,399,414
8432,496,622,126,11,112,127
8433,6,186,180,13,166,181
8434,822,698,-124,57,862,877
8435,873,136,-737,20,249,264
8436,671,422,-249,51,737,752
8437,849,870,21,4,7,22
8438,801,381,-420,38,566,581
8439,416,177,-239,50,747,762
8440,754,926,172,13,158,173
8441,701,449,-252,49,734,749
8442,462,539,77,8,63,78
8443,225,168,-57,63,929,944
8444,809,234,-575,29,411,426
8445,157,581,424,28,410,425
8446,374,336,-38,62,948,963
8447,83,50,-33,64,953,968
8448,945,571,-374,41,612,627
8449,175,278,103,10,89,104
8450,367,954,587,40,573,588
8451,236,642,406,28,392,407
8452,338,789,451,31,437,452
8453,601,869,268,19,254,269
8454,907,986,79,9,65,80
8455,145,478,333,24,319,334
8456,598,341,-257,50,729,744
8457,574,140,-434,38,552,567
8458,637,811,174,14,160,175
8459,759,929,170,13,156,171
8460,136,939,803,53,789,804
8461,632,854,222,17,208,223
8462,370,976,606,41,592,607
8463,791,481,-310,45,676,691
8464,801,615,-186,54,800,815
8465,710,268,-442,38,544,559
8466,444,615,171,14,157,172
8467,966,987,21,4,7,22
8468,382,236,-146,56,840,855
8469,248,520,272,18,258,273
8470,944,985,41,5,27,42
8471,600,998,398,28,384,399
8472,150,88,-62,61,924,939
8473,980,816,-164,54,822,837
8474,710,142,-568,28,418,433
8475,637,223,-414,39,572,587
8476,529,522,-7,64,979,994
8477,296,864,568,37,554,569
8478,789,933,144,10,130,145
8479,631,277,-354,43,632,647
8480,415,858,443,31,429,444
8481,616,812,196,14,182,197
8482,900,291,-609,28,377,392
8483,119,922,803,53,789,804
8484,981,384,-597,28,389,404
8485,795,203,-592,27,394,409
8486,655,369,-286,47,700,715
8487,265,895,630,42,616,631
8488,834,733,-101,59,885,900
8489,688,579,-109,59,877,892
8490,72,986,914,59,900,915
8491,698,909,211,16,197,212
8492,863,83,-780,16,206,221
8493,573,810,237,18,223,238
8494,322,78,-244,49,742,757
8495,16,681,665,44,651,666
8496,198,263,65,6,51,66
8497,928,570,-358,42,628,643
8498,747,286,-461,37,525,540
8499,602,581,-21,64,965,980
8500,14,833,819,54,805,820
8501,806,596,-210,52,776,791
8502,683,704,21,4,7,22
8503,289,702,413,29,399,414
8504,259,828,569,38,555,570
8505,739,634,-105,60,881,896
8506,516,504,-12,64,974,989
8507,110,859,749,50,735,750
8508,115,435,320,21,306,321
8509,665,18,-647,24,339,354
8510,460,324,-136,55,850,865
8511,42,566,524,35,510,525
8512,393,189,-204,52,782,797
8513,489,286,-203,53,783,798
8514,733,501,-232,49,754,769
8515,402,533,131,11,117,132
8516,595,141,-454,36,532,547
8517,361,463,102,9,88,103
8518,927,540,-387,41,599,614
8519,667,99,-568,28,418,433
8520,392,177,-215,51,771,786
8521,70,178,108,9,94,109
8522,112,378,266,19,252,267
8523,535,642,107,10,93,108
8524,583,145,-438,37,548,563
8525,695,563,-132,56,854,869
8526,551,501,-50,62,936,951
8527,411,818,407,29,393,408
8528,207,383,176,12,162,177
8529,572,610,38,5,24,39
8530,265,513,248,17,234,249
8531,69,308,239,19,225,240
8532,859,629,-230,50,756,771
8533,505,73,-432,37,554,569
8534,633,213,-420,38,566,581
8535,912,322,-590,28,396,411
8536,402,112,-290,47,696,711
8537,5,74,69,7,55,70
8538,159,198,39,6,25,40
8539,24,53,29,5,15,30
8540,941,426,-515,33,471,486
8541,412,899,487,34,473,488
8542,557,717,160,11,146,161
8543,818,660,-158,55,828,843
8544,65,915,850,55,836,851
8545,638,252,-386,41,600,615
8546,259,185,-74,61,912,927
8547,844,941,97,8,83,98
8548,76,3,-73,62,913,928
8549,355,466,111,11,97,112
8550,917,442,-475,36,511,526
8551,151,356,205,16,191,206
8552,781,571,-210,52,776,791
8553,879,535,-344,42,642,657
8554,58,492,434,29,420,435
8555,916,857,-59,62,927,942
8556,170,72,-98,59,888,903
8557,43,438,395,28,381,396
8558,915,548,-367,42,619,634
8559,387,293,-94,59,892,907
8560,752,488,-264,47,722,737
8561,982,396,-586,29,400,415
8562,117,618,501,34,487,502
8563,472,795,323,23,309,324
8564,990,859,-131,57,855,870
8565,270,680,410,28,396,411
8566,206,839,633,42,619,634
8567,370,340,-30,63,956,971
8568,648,262,-386,41,600,615
8569,644,354,-290,47,696,711
8570,94,205,111,11,97,112
8571,222,42,-180,53,806,821
8572,711,821,110,10,96,111
8573,258,824,566,38,552,567
8574,821,638,-183,53,803,818
8575,589,785,196,14,182,197
8576,588,813,225,16,211,226
8577,159,206,47,7,33,48
8578,723,391,-332,44,654,669
8579,659,903,244,17,230,245
8580,900,598,-302,46,684,699
8581,656,344,-312,44,674,689
8582,765,878,113,9,99,114
8583,618,872,254,19,240,255
8584,240,846,606,41,592,607
8585,911,931,20,3,6,21
8586,65,889,824,53,810,825
8587,653,610,-43,63,943,958
8588,370,850,480,31,466,481
8589,276,912,636,42,622,637
8590,1,853,852,55,838,853
8591,658,870,212,15,198,213
8592,79,491,412,28,398,413
8593,319,108,-211,52,775,790
8594,815,232,-583,28,403,418
8595,714,41,-673,24,313,328
8596,80,951,871,58,857,872
8597,597,82,-515,33,471,486
8598,77,347,270,20,256,271
8599,322,698,376,25,362,377
8600,842,27,-815,14,171,186
8601,96,158,62,7,48,63
8602,179,392,213,16,199,214
8603,560,877,317,23,303,318
8604,845,128,-717,21,269,284
8605,761,423,-338,44,648,663
8606,175,4,-171,55,815,830
8607,697,99,-598,27,388,403
8608,807,772,-35,63,951,966
8609,805,702,-103,58,883,898
8610,147,221,74,7,60,75
8611,659,279,-380,41,606,621
8612,772,449,-323,45,663,678
8613,606,742,136,10,122,137
8614,657,423,-234,51,752,767
8615,886,158,-728,18,258,273
8616,825,928,103,10,89,104
8617,684,832,148,11,134,149
8618,775,317,-458,37,528,543
8619,468,267,-201,54,785,800
8620,905,497,-408,38,578,593
8621,948,701,-247,49,739,754
8622,336,980,644,42,630,645
8623,466,367,-99,59,887,902
8624,529,538,9,3,3,10
8625,5,503,498,33,484,499
8626,897,876,-21,64,965,980
8627,808,280,-528,31,458,473
8628,760,213,-547,31,439,454
8629,603,118,-485,35,501,516
8630,840,295,-545,32,441,456
8631,484,763,279,21,265,280
8632,373,67,-306,46,680,695
8633,739,425,-314,46,672,687
8634,588,55,-533,32,453,468
8635,788,491,-297,48,689,704
8636,203,649,446,31,432,447
8637,603,220,-383,41,603,618
8638,525,376,-149,56,837,852
8639,184,448,264,18,250,265
8640,492,661,169,13,155,170
8641,60,39,-21,64,965,980
8642,239,441,202,15,188,203
8643,570,308,-262,48,724,739
8644,495,682,187,15,173,188
8645,679,143,-536,30,450,465
8646,217,278,61,7,47,62
8647,971,640,-331,45,655,670
8648,350,974,624,40,610,625
8649,283,612,329,23,315,330
8650,116,691,575,40,561,576
8651,223,751,528,34,514,529
8652,942,648,-294,46,692,707
8653,608,998,390,27,376,391
8654,274,110,-164,54,822,837
8655,698,78,-620,26,366,381
8656,774,910,136,10,122,137
8657,541,291,-250,50,736,751
8658,207,86,-121,59,865,880
8659,834,397,-437,38,549,564
8660,972,944,-28,63,958,973
8661,237,376,139,12,125,140
8662,795,671,-124,57,862,877
8663,937,355,-582,28,404,419
8664,813,726,-87,59,899,914
8665,681,698,17,3,3,18
8666,963,320,-643,25,343,358
8667,76,85,9,3,3,10
8668,940,358,-582,28,404,419
8669,747,841,94,9,80,95
8670,364,220,-144,55,842,857
8671,825,105,-720,19,266,281
8672,234,770,536,35,522,537
8673,704,232,-472,34,514,529
8674,231,395,164,12,150,165
8675,284,616,332,23,318,333
8676,4,189,185,14,171,186
8677,902,216,-686,22,300,315
8678,522,689,167,14,153,168
8679,770,184,-586,29,400,415
8680,714,855,141,12,127,142
8681,868,517,-351,43,635,650
8682,799,900,101,9,87,102
8683,834,551,-283,48,703,718
8684,3,1,-2,65,984,999
8685,738,465,-273,49,713,728
8686,123,645,522,35,508,523
8687,696,442,-254,49,732,747
8688,111,986,875,58,861,876
8689,846,924,78,8,64,79
8690,106,294,188,14,174,189
8691,452,908,456,30,442,457
8692,321,159,-162,55,824,839
8693,274,323,49,5,35,50
8694,114,97,-17,65,969,984
8695,877,707,-170,55,816,831
8696,355,533,178,13,164,179
8697,892,473,-419,39,567,582
8698,555,280,-275,48,711,726
8699,388,7,-381,42,605,620
8700,496,765,269,20,255,270
8701,23,807,784,50,770,785
8702,602,745,143,13,129,144
8703,273,506,233,17,219,234
8704,89,548,459,32,445,460
8705,199,760,561,37,547,562
8706,502,970,468,31,454,469
8707,41,203,162,12,148,163
8708,239,212,-27,64,959,974
8709,296,208,-88,58,898,913
8710,157,679,522,35,508,523
8711,981,606,-375,41,611,626
8712,102,664,562,37,548,563
8713,670,288,-382,41,604,619
8714,982,873,-109,59,877,892
8715,4,152,148,11,134,149
8716,347,837,490,33,476,491
8717,46,303,257,18,243,258
8718,981,19,-962,5,24,39
8719,973,242,-731,20,255,270
8720,377,112,-265,50,721,736
8721,416,857,441,30,427,442
8722,771,144,-627,26,359,374
8723,946,55,-891,10,95,110
8724,305,84,-221,52,765,780
8725,330,274,-56,60,930,945
8726,148,560,412,28,398,413
8727,745,331,-414,39,572,587
8728,661,645,-16,63,970,985
8729,831,606,-225,52,761,776
8730,872,316,-556,30,430,445
8731,813,211,-602,28,384,399
8732,69,629,560,36,546,561
8733,597,874,277,20,263,278
8734,133,102,-31,63,955,970
8735,179,613,434,29,420,435
8736,418,400,-18,64,968,983
8737,672,791,119,11,105,120
8738,371,372,1,2,2,2
8739,226,347,121,10,107,122
8740,653,480,-173,55,813,828
8741,356,597,241,17,227,242
8742,227,353,126,11,112,127
8743,248,938,690,45,676,691
8744,424,13,-411,40,575,590
8745,186,8,-178,54,808,823
8746,230,833,603,41,589,604
8747,515,809,294,21,280,295
8748,98,3,-95,59,891,906
8749,603,9,-594,28,392,407
8750,325,59,-266,49,720,735
8751,52,369,317,23,303,318
8752,452,541,89,8,75,90
8753,62,809,747,50,733,748
8754,512,439,-73,62,913,928
8755,940,651,-289,48,697,712
8756,707,520,-187,54,799,814
8757,464,792,328,22,314,329
8758,335,942,607,42,593,608
8759,298,747,449,30,435,450
8760,401,70,-331,45,655,670
8761,123,631,508,34,494,509
8762,949,322,-627,26,359,374
8763,806,308,-498,34,488,503
8764,484,295,-189,54,797,812
8765,853,102,-751,18,235,250
8766,663,273,-390,40,596,611
8767,528,234,-294,46,692,707
8768,282,446,164,12,150,165
8769,45,510,465,31,451,466
8770,861,571,-290,47,696,711
8771,646,606,-40,61,946,961
8772,562,261,-301,47,685,700
8773,592,879,287,22,273,288
8774,675,83,-592,27,394,409
8775,863,245,-618,27,368,383
8776,736,784,48,4,34,49
8777,845,959,114,9,100,115
8778,705,392,-313,47,673,688
8779,50,575,525,36,511,526
8780,744,693,-51,62,935,950
8781,394,935,541,37,527,542
8782,51,448,397,28,383,398
8783,464,233,-231,50,755,770
8784,768,841,73,7,59,74
8785,597,175,-422,38,564,579
8786,977,879,-98,59,888,903
8787,617,599,-18,64,968,983
8788,761,239,-522,33,464,479
8789,186,180,-6,64,980,995
8790,570,34,-536,30,450,465
8791,358,375,17,3,3,18
8792,945,375,-570,30,416,431
8793,636,837,201,15,187,202
8794,150,295,145,11,131,146
8795,297,463,166,13,152,167
8796,454,354,-100,58,886,901
8797,148,981,833,54,819,834
8798,231,546,315,23,301,316
8799,234,550,316,22,302,317
8800,560,288,-272,47,714,729
8801,580,666,86,8,72,87
8802,762,186,-576,28,410,425
8803,161,690,529,35,515,530
8804,646,37,-609,28,377,392
8805,318,538,220,16,206,221
8806,658,206,-452,36,534,549
8807,492,876,384,25,370,385
8808,143,468,325,23,311,326
8809,454,455,1,2,2,2
8810,459,63,-396,40,590,605
8811,682,263,-419,39,567,582
8812,411,493,82,7,68,83
8813,504,2,-502,33,484,499
8814,890,816,-74,61,912,927
8815,123,92,-31,63,955,970
8816,890,565,-325,45,661,676
8817,204,409,205,16,191,206
8818,821,766,-55,61,931,946
8819,911,166,-745,20,241,256
8820,311,161,-150,55,836,851
8821,582,415,-167,54,819,834
8822,465,114,-351,43,635,650
8823,24,720,696,45,682,697
8824,393,884,491,34,477,492
8825,714,637,-77,61,909,924
8826,692,223,-469,36,517,532
8827,668,382,-286,47,700,715
8828,949,579,-370,42,616,631
8829,174,136,-38,62,948,963
8830,32,284,252,18,238,253
8831,384,572,188,14,174,189
8832,107,833,726,48,712,727
8833,493,625,132,10,118,133
8834,507,361,-146,56,840,855
8835,44,48,4,2,2,5
8836,460,40,-420,38,566,581
8837,116,801,685,46,671,686
8838,499,60,-439,37,547,562
8839,342,4,-338,44,648,663
8840,821,948,127,12,113,128
8841,787,949,162,12,148,163
8842,710,426,-284,47,702,717
8843,859,912,53,6,39,54
8844,326,940,614,41,600,615
8845,498,188,-310,45,676,691
8846,13,439,426,29,412,427
8847,416,801,385,26,371,386
8848,242,855,613,41,599,614
8849,789,225,-564,29,422,437
8850,978,611,-367,42,619,634
8851,836,587,-249,51,737,752
8852,560,883,323,23,309,324
8853,553,465,-88,58,898,913
8854,10,641,631,43,617,632
8855,417,139,-278,47,708,723
8856,709,555,-154,56,832,847
8857,878,586,-292,46,694,709
8858,373,333,-40,61,946,961
8859,979,804,-175,54,811,826
8860,447,722,275,20,261,276
8861,162,17,-145,57,841,856
8862,998,362,-636,25,350,365
8863,954,866,-88,58,898,913
8864,608,637,29,5,15,30
8865,274,673,399,29,385,400
8866,690,991,301,22,287,302
8867,683,61,-622,26,364,379
8868,527,490,-37,63,949,964
8869,302,59,-243,50,743,758
8870,15,366,351,26,337,352
8871,256,323,67,7,53,68
8872,850,122,-728,18,258,273
8873,416,436,20,3,6,21
8874,693,63,-630,25,356,371
8875,336,330,-6,64,980,995
8876,74,999,925,61,911,926
8877,178,881,703,48,689,704
8878,643,831,188,14,174,189
8879,448,305,-143,56,843,858
8880,503,112,-391,40,595,610
8881,70,752,682,45,668,683
8882,819,362,-457,38,529,544
8883,987,199,-788,15,198,213
8884,435,613,178,13,164,179
8885,727,788,61,7,47,62
8886,653,394,-259,49,727,742
8887,352,569,217,16,203,218
8888,777,468,-309,46,677,692
8889,418,216,-202,53,784,799
8890,569,624,55,7,41,56
8891,391,532,141,12,127,142
8892,893,231,-662,23,324,339
8893,165,250,85,8,71,86
8894,287,714,427,30,413,428
8895,593,352,-241,51,745,760
8896,945,429,-516,32,470,485
8897,494,12,-482,35,504,519
8898,650,852,202,15,188,203
8899,285,23,-262,48,724,739
8900,678,95,-583,28,403,418
8901,587,365,-222,51,764,779
8902,797,632,-165,55,821,836
8903,409,22,-387,41,599,614
8904,345,851,506,34,492,507
8905,689,641,-48,61,938,953
8906,716,384,-332,44,654,669
8907,704,66,-638,25,348,363
8908,563,852,289,20,275,290
8909,899,308,-591,28,395,410
8910,860,950,90,8,76,91
8911,91,74,-17,65,969,984
8912,332,99,-233,52,753,768
8913,896,337,-559,30,427,442
8914,209,700,491,34,477,492
8915,19,795,776,50,762,777
8916,588,195,-393,42,593,608
8917,380,896,516,34,502,517
8918,146,169,23,5,9,24
8919,197,219,22,4,8,23
8920,31,187,156,12,142,157
8921,998,744,-254,49,732,747
8922,500,666,166,13,152,167
8923,5,798,793,52,779,794
8924,152,159,7,4,5,8
8925,555,971,416,27,402,417
8926,477,98,-379,42,607,622
8927,620,453,-167,54,819,834
8928,544,658,114,9,100,115
8929,30,232,202,15,188,203
8930,543,265,-278,47,708,723
8931,861,746,-115,58,871,886
8932,605,435,-170,55,816,831
8933,835,257,-578,29,408,423
8934,48,918,870,57,856,871
8935,138,646,508,34,494,509
8936,896,676,-220,51,766,781
8937,623,543,-80,59,906,921
8938,192,514,322,22,308,323
8939,549,660,111,11,97,112
8940,985,348,-637,26,349,364
8941,824,503,-321,46,665,680
8942,712,393,-319,45,667,682
8943,770,409,-361,44,625,640
8944,34,643,609,40,595,610
8945,661,461,-200,51,786,801
8946,641,232,-409,41,577,592
8947,561,82,-479,35,507,522
8948,187,742,555,38,541,556
8949,934,824,-110,58,876,891
8950,237,518,281,20,267,282
8951,553,953,400,26,386,401
8952,667,985,318,23,304,319
8953,154,953,799,54,785,800
8954,802,904,102,9,88,103
8955,150,969,819,54,805,820
8956,494,492,-2,65,984,999
8957,716,223,-493,35,493,508
8958,989,326,-663,23,323,338
8959,41,558,517,35,503,518
8960,372,886,514,34,500,515
8961,12,656,644,42,630,645
8962,493,986,493,34,479,494
8963,954,471,-483,35,503,518
8964,189,486,297,21,283,298
8965,34,948,914,59,900,915
8966,90,2,-88,58,898,913
8967,338,370,32,3,18,33
8968,724,526,-198,52,788,803
8969,988,362,-626,26,360,375
8970,469,708,239,19,225,240
8971,15,803,788,51,774,789
8972,504,869,365,26,351,366
8973,535,190,-345,45,641,656
8974,480,568,88,7,74,89
8975,710,891,181,14,167,182
8976,851,51,-800,14,186,201
8977,903,19,-884,9,102,117
8978,832,907,75,8,61,76
8979,258,80,-178,54,808,823
8980,163,179,16,2,2,17
8981,13,265,252,18,238,253
8982,153,378,225,16,211,226
8983,430,384,-46,62,940,955
8984,838,730,-108,58,878,893
8985,971,970,-1,66,985,1000
8986,843,50,-793,17,193,208
8987,889,496,-393,42,593,608
8988,302,67,-235,51,751,766
8989,20,54,34,4,20,35
8990,50,254,204,15,190,205
8991,895,258,-637,26,349,364
8992,233,313,80,6,66,81
8993,961,529,-432,37,554,569
8994,899,808,-91,60,895,910
8995,300,102,-198,52,788,803
8996,582,914,332,23,318,333
8997,624,91,-533,32,453,468
8998,859,953,94,9,80,95
8999,99,667,568,37,554,569
9000,877,44,-833,14,153,168
9001,382,247,-135,56,851,866
9002,158,421,263,20,249,264
9003,86,227,141,12,127,142
9004,733,780,47,7,33,48
9005,150,949,799,54,785,800
9006,9,47,38,5,24,39
9007,773,675,-98,59,888,903
9008,738,983,245,18,231,246
9009,179,347,168,12,154,169
9010,917,431,-486,34,500,515
9011,808,685,-123,58,863,878
9012,902,421,-481,36,505,520
9013,505,284,-221,52,765,780
9014,188,970,782,52,768,783
9015,608,860,252,18,238,253
9016,137,784,647,44,633,648
9017,518,65,-453,37,533,548
9018,81,25,-56,60,930,945
9019,274,524,250,18,236,251
9020,96,899,803,53,789,804
9021,732,349,-383,41,603,618
9022,83,625,542,37,528,543
9023,367,617,250,18,236,251
9024,652,607,-45,63,941,956
9025,712,616,-96,58,890,905
9026,373,464,91,9,77,92
9027,710,460,-250,50,736,751
9028,923,80,-843,13,143,158
9029,119,90,-29,64,957,972
9030,393,123,-270,48,716,731
9031,153,899,746,49,732,747
9032,658,5,-653,25,333,348
9033,84,327,243,18,229,244
9034,756,766,10,3,4,11
9035,302,287,-15,64,971,986
9036,241,961,720,46,706,721
9037,815,408,-407,39,579,594
9038,653,309,-344,42,642,657
9039,966,707,-259,49,727,742
9040,768,731,-37,63,949,964
9041,447,549,102,9,88,103
9042,195,671,476,32,462,477
9043,779,275,-504,32,482,497
9044,952,145,-807,14,179,194
9045,768,835,67,7,53,68
9046,720,595,-125,58,861,876
9047,619,338,-281,49,705,720
9048,192,400,208,14,194,209
9049,849,629,-220,51,766,781
9050,569,893,324,22,310,325
9051,864,858,-6,64,980,995
9052,241,890,649,43,635,650
9053,813,645,-168,53,818,833
9054,127,244,117,10,103,118
9055,84,325,241,17,227,242
9056,1,298,297,21,283,298
9057,522,155,-367,42,619,634
9058,15,148,133,11,119,134
9059,579,223,-356,42,630,645
9060,728,927,199,16,185,200
9061,226,939,713,47,699,714
9062,634,994,360,24,346,361
9063,636,574,-62,61,924,939
9064,861,976,115,10,101,116
9065,997,693,-304,45,682,697
9066,438,565,127,12,113,128
9067,933,170,-763,18,223,238
9068,809,831,22,4,8,23
9069,926,103,-823,13,163,178
9070,625,448,-177,55,809,824
9071,473,794,321,22,307,322
9072,675,334,-341,44,645,660
9073,43,388,345,24,331,346
9074,894,149,-745,20,241,256
9075,330,354,24,3,10,25
9076,410,935,525,36,511,526
9077,415,837,422,29,408,423
9078,566,43,-523,33,463,478
9079,758,295,-463,36,523,538
9080,962,476,-486,34,500,515
9081,74,191,117,10,103,118
9082,140,196,56,5,42,57
9083,180,476,296,20,282,297
9084,950,539,-411,40,575,590
9085,275,720,445,31,431,446
9086,47,510,463,33,449,464
9087,243,558,315,23,301,316
9088,694,919,225,16,211,226
9089,23,732,709,47,695,710
9090,205,659,454,31,440,455
9091,502,429,-73,62,913,928
9092,485,409,-76,60,910,925
9093,723,827,104,8,90,105
9094,805,903,98,8,84,99
9095,209,203,-6,64,980,995
9096,349,925,576,37,562,577
9097,538,968,430,30,416,431
9098,909,227,-682,23,304,319
9099,310,534,224,15,210,225
9100,679,400,-279,47,707,722
9101,465,29,-436,37,550,565
9102,167,268,101,9,87,102
9103,550,657,107,10,93,108
9104,139,751,612,40,598,613
9105,346,997,651,44,637,652
9106,787,498,-289,48,697,712
9107,2,928,926,61,912,927
9108,196,369,173,14,159,174
9109,247,850,603,41,589,604
9110,903,966,63,8,49,64
9111,510,700,190,15,176,191
9112,65,194,129,10,115,130
9113,643,997,354,24,340,355
9114,459,226,-233,52,753,768
9115,100,407,307,22,293,308
9116,447,798,351,26,337,352
9117,539,389,-150,55,836,851
9118,16,269,253,19,239,254
9119,708,818,110,10,96,111
9120,608,348,-260,48,726,741
9121,206,282,76,7,62,77
9122,169,755,586,39,572,587
9123,324,958,634,42,620,635
9124,11,765,754,49,740,755
9125,509,942,433,29,419,434
9126,180,938,758,50,744,759
9127,487,840,353,24,339,354
9128,836,740,-96,58,890,905
9129,789,344,-445,38,541,556
9130,182,247,65,6,51,66
9131,399,852,453,31,439,454
9132,674,957,283,21,269,284
9133,25,521,496,32,482,497
9134,241,312,71,8,57,72
9135,781,799,18,3,4,19
9136,267,784,517,35,503,518
9137,860,552,-308,45,678,693
9138,18,986,968,62,954,969
9139,469,706,237,18,223,238
9140,987,40,-947,6,39,54
9141,33,54,21,4,7,22
9142,647,580,-67,61,919,934
9143,856,87,-769,18,217,232
9144,740,427,-313,47,673,688
9145,987,907,-80,59,906,921
9146,709,9,-700,21,286,301
9147,368,42,-326,44,660,675
9148,998,740,-258,49,728,743
9149,401,111,-290,47,696,711
9150,255,576,321,22,307,322
9151,20,613,593,39,579,594
9152,997,547,-450,37,536,551
9153,371,995,624,40,610,625
9154,48,663,615,42,601,616
9155,363,462,99,9,85,100
9156,559,603,44,5,30,45
9157,334,79,-255,49,731,746
9158,734,196,-538,32,448,463
9159,236,429,193,14,179,194
9160,75,522,447,32,433,448
9161,375,249,-126,57,860,875
9162,544,146,-398,40,588,603
9163,610,787,177,13,163,178
9164,783,967,184,13,170,185
9165,362,622,260,18,246,261
9166,942,703,-239,50,747,762
9167,307,6,-301,47,685,700
9168,776,154,-622,26,364,379
9169,28,651,623,43,609,624
9170,91,90,-1,66,985,1000
9171,278,467,189,15,175,190
9172,735,583,-152,54,834,849
9173,768,26,-742,18,244,259
9174,843,778,-65,62,921,936
9175,310,322,12,3,6,13
9176,15,411,396,27,382,397
9177,677,124,-553,32,433,448
9178,993,990,-3,65,983,998
9179,157,422,265,19,251,266
9180,726,540,-186,54,800,815
9181,911,491,-420,38,566,581
9182,732,266,-466,36,520,535
9183,145,996,851,56,837,852
9184,150,991,841,55,827,842
9185,615,236,-379,42,607,622
9186,897,504,-393,42,593,608
9187,611,270,-341,44,645,660
9188,970,265,-705,22,281,296
9189,185,792,607,42,593,608
9190,263,598,335,25,321,336
9191,156,179,23,5,9,24
9192,803,709,-94,59,892,907
9193,197,760,563,38,549,564
9194,495,672,177,13,163,178
9195,604,639,35,5,21,36
9196,594,791,197,15,183,198
9197,547,935,388,26,374,389
9198,876,703,-173,55,813,828
9199,428,129,-299,47,687,702
9200,20,808,788,51,774,789
9201,819,754,-65,62,921,936
9202,93,303,210,15,196,211
9203,801,335,-466,36,520,535
9204,347,398,51,6,37,52
9205,280,962,682,45,668,683
9206,113,631,518,35,504,519
9207,445,53,-392,39,594,609
9208,30,888,858,56,844,859
9209,353,331,-22,63,964,979
9210,272,852,580,38,566,581
9211,160,551,391,28,377,392
9212,64,578,514,34,500,515
9213,887,860,-27,64,959,974
9214,219,538,319,24,305,320
9215,595,161,-434,38,552,567
9216,515,314,-201,54,785,800
9217,610,460,-150,55,836,851
9218,688,488,-200,51,786,801
9219,581,806,225,16,211,226
9220,505,86,-419,39,567,582
9221,120,485,365,26,351,366
9222,600,614,14,4,8,15
9223,444,795,351,26,337,352
9224,192,288,96,7,82,97
9225,428,644,216,15,202,217
9226,857,541,-316,45,670,685
9227,240,646,406,28,392,407
9228,421,852,431,31,417,432
9229,433,182,-251,50,735,750
9230,562,983,421,29,407,422
9231,491,701,210,15,196,211
9232,84,960,876,57,862,877
9233,500,606,106,9,92,107
9234,172,940,768,49,754,769
9235,661,851,190,15,176,191
9236,315,395,80,6,66,81
9237,790,799,9,3,3,10
9238,586,429,-157,56,829,844
9239,611,150,-461,37,525,540
9240,900,969,69,7,55,70
9241,424,374,-50,62,936,951
9242,969,331,-638,25,348,363
9243,258,659,401,27,387,402
9244,513,943,430,30,416,431
9245,548,53,-495,34,491,506
9246,905,276,-629,26,357,372
9247,394,196,-198,52,788,803
9248,615,991,376,25,362,377
9249,181,991,810,53,796,811
9250,630,545,-85,60,901,916
9251,794,696,-98,59,888,903
9252,489,642,153,12,139,154
9253,866,446,-420,38,566,581
9254,98,725,627,42,613,628
9255,843,862,19,4,5,20
9256,916,512,-404,39,582,597
9257,704,311,-393,42,593,608
9258,418,330,-88,58,898,913
9259,696,115,-581,29,405,420
9260,88,166,78,8,64,79
9261,386,400,14,4,8,15
9262,336,689,353,24,339,354
9263,640,992,352,23,338,353
9264,173,979,806,53,792,807
9265,603,845,242,17,228,243
9266,140,775,635,43,621,636
9267,870,381,-489,36,497,512
9268,137,443,306,21,292,307
9269,101,726,625,41,611,626
9270,591,353,-238,50,748,763
9271,848,923,75,8,61,76
9272,711,404,-307,46,679,694
9273,821,369,-452,36,534,549
9274,110,164,54,6,40,55
9275,756,849,93,9,79,94
9276,417,111,-306,46,680,695
9277,3,453,450,30,436,451
9278,395,990,595,40,581,596
9279,122,901,779,52,765,780
9280,922,444,-478,35,508,523
9281,696,430,-266,49,720,735
9282,641,147,-494,34,492,507
9283,430,422,-8,63,978,993
9284,332,455,123,11,109,124
9285,861,476,-385,42,601,616
9286,563,677,114,9,100,115
9287,250,135,-115,58,871,886
9288,574,489,-85,60,901,916
9289,269,17,-252,49,734,749
9290,182,297,115,10,101,116
9291,782,538,-244,49,742,757
9292,172,524,352,23,338,353
9293,198,866,668,44,654,669
9294,65,225,160,11,146,161
9295,955,20,-935,6,51,66
9296,773,213,-560,29,426,441
9297,923,150,-773,17,213,228
9298,86,868,782,52,768,783
9299,152,997,845,56,831,846
9300,444,482,38,5,24,39
9301,261,738,477,33,463,478
9302,840,374,-466,36,520,535
9303,16,736,720,46,706,721
9304,337,992,655,45,641,656
9305,630,68,-562,30,424,439
9306,261,781,520,34,506,521
9307,387,177,-210,52,776,791
9308,18,498,480,31,466,481
9309,211,203,-8,63,978,993
9310,577,38,-539,32,447,462
9311,544,641,97,8,83,98
9312,311,263,-48,61,938,953
9313,914,562,-352,42,634,649
9314,774,367,-407,39,579,594
9315,539,809,270,20,256,271
9316,213,921,708,46,694,709
9317,768,86,-682,23,304,319
9318,108,846,738,48,724,739
9319,901,931,30,5,16,31
9320,391,430,39,6,25,40
9321,322,412,90,8,76,91
9322,319,919,600,39,586,601
9323,350,767,417,28,403,418
9324,669,352,-317,46,669,684
9325,949,176,-773,17,213,228
9326,965,999,34,4,20,35
9327,679,709,30,5,16,31
9328,473,512,39,6,25,40
9329,713,251,-462,36,524,539
9330,448,133,-315,46,671,686
9331,620,927,307,22,293,308
9332,912,105,-807,14,179,194
9333,58,232,174,14,160,175
9334,262,328,66,6,52,67
9335,417,649,232,16,218,233
9336,387,182,-205,53,781,796
9337,613,103,-510,33,476,491
9338,44,168,124,10,110,125
9339,180,691,511,36,497,512
9340,924,963,39,6,25,40
9341,989,90,-899,9,87,102
9342,869,475,-394,41,592,607
9343,740,691,-49,63,937,952
9344,389,119,-270,48,716,731
9345,186,204,18,3,4,19
9346,513,883,370,25,356,371
9347,990,814,-176,53,810,825
9348,125,651,526,36,512,527
9349,954,934,-20,63,966,981
9350,400,503,103,10,89,104
9351,542,755,213,16,199,214
9352,799,76,-723,20,263,278
9353,405,683,278,20,264,279
9354,362,942,580,38,566,581
9355,292,613,321,22,307,322
9356,698,522,-176,53,810,825
9357,100,67,-33,64,953,968
9358,118,744,626,41,612,627
9359,323,53,-270,48,716,731
9360,68,596,528,34,514,529
9361,20,230,210,15,196,211
9362,437,22,-415,39,571,586
9363,341,695,354,24,340,355
9364,754,73,-681,24,305,320
9365,40,848,808,52,794,809
9366,92,777,685,46,671,686
9367,151,809,658,43,644,659
9368,685,329,-356,42,630,645
9369,214,356,142,12,128,143
9370,576,710,134,11,120,135
9371,978,410,-568,28,418,433
9372,816,761,-55,61,931,946
9373,583,923,340,23,326,341
9374,428,413,-15,64,971,986
9375,254,668,414,29,400,415
9376,726,505,-221,52,765,780
9377,620,510,-110,58,876,891
9378,353,302,-51,62,935,950
9379,987,26,-961,6,25,40
9380,736,379,-357,43,629,644
9381,241,197,-44,62,942,957
9382,608,209,-399,40,587,602
9383,727,297,-430,38,556,571
9384,916,536,-380,41,606,621
9385,976,16,-960,4,26,41
9386,765,186,-579,29,407,422
9387,213,288,75,8,61,76
9388,965,190,-775,16,211,226
9389,786,985,199,16,185,200
9390,850,53,-797,16,189,204
9391,1,106,105,9,91,106
9392,371,671,300,21,286,301
9393,655,24,-631,25,355,370
9394,348,927,579,39,565,580
9395,88,728,640,41,626,641
9396,369,179,-190,53,796,811
9397,692,474,-218,52,768,783
9398,469,359,-110,58,876,891
9399,38,358,320,21,306,321
9400,383,679,296,20,282,297
9401,790,591,-199,52,787,802
9402,106,599,493,34,479,494
9403,286,95,-191,53,795,810
9404,80,440,360,24,346,361
9405,126,811,685,46,671,686
9406,672,600,-72,59,914,929
9407,387,694,307,22,293,308
9408,508,609,101,9,87,102
9409,36,524,488,32,474,489
9410,313,878,565,38,551,566
9411,887,122,-765,18,221,236
9412,922,314,-608,26,378,393
9413,448,524,76,7,62,77
9414,631,151,-480,34,506,521
9415,592,429,-163,55,823,838
9416,910,809,-101,59,885,900
9417,465,728,263,20,249,264
9418,936,114,-822,13,164,179
9419,846,762,-84,59,902,917
9420,249,137,-112,57,874,889
9421,926,637,-289,48,697,712
9422,748,431,-317,46,669,684
9423,840,584,-256,48,730,745
9424,342,900,558,38,544,559
9425,236,323,87,9,73,88
9426,51,377,326,23,312,327
9427,705,780,75,8,61,76
9428,79,675,596,39,582,597
9429,141,758,617,41,603,618
9430,689,206,-483,35,503,518
9431,517,30,-487,34,499,514
9432,963,626,-337,45,649,664
9433,862,986,124,10,110,125
9434,176,783,607,42,593,608
9435,117,191,74,7,60,75
9436,200,524,324,22,310,325
9437,698,387,-311,45,675,690
9438,297,472,175,15,161,176
9439,818,15,-803,15,183,198
9440,375,807,432,28,418,433
9441,129,287,158,13,144,159
9442,209,754,545,36,531,546
9443,822,139,-683,23,303,318
9444,45,947,902,59,888,903
9445,30,624,594,39,580,595
9446,790,175,-615,26,371,386
9447,461,84,-377,43,609,624
9448,408,78,-330,45,656,671
9449,59,530,471,33,457,472
9450,667,319,-348,43,638,653
9451,399,713,314,22,300,315
9452,208,959,751,51,737,752
9453,715,275,-440,36,546,561
9454,603,411,-192,52,794,809
9455,730,498,-232,49,754,769
9456,142,117,-25,65,961,976
9457,410,830,420,28,406,421
9458,460,284,-176,53,810,825
9459,579,653,74,7,60,75
9460,775,900,125,11,111,126
9461,624,31,-593,29,393,408
9462,158,829,671,46,657,672
9463,144,977,833,54,819,834
9464,921,547,-374,41,612,627
9465,876,479,-397,41,589,604
9466,961,753,-208,51,778,793
9467,409,644,235,18,221,236
9468,930,966,36,4,22,37
9469,821,19,-802,15,184,199
9470,318,781,463,33,449,464
9471,159,28,-131,57,855,870
9472,342,321,-21,64,965,980
9473,59,501,442,30,428,443
9474,567,379,-188,53,798,813
9475,955,998,43,6,29,44
9476,842,922,80,6,66,81
9477,170,339,169,13,155,170
9478,588,380,-208,51,778,793
9479,74,234,160,11,146,161
9480,763,790,27,5,13,28
9481,861,726,-135,56,851,866
9482,435,620,185,14,171,186
9483,581,468,-113,59,873,888
9484,314,8,-306,46,680,695
9485,195,291,96,7,82,97
9486,141,917,776,50,762,777
9487,147,798,651,44,637,652
9488,659,99,-560,29,426,441
9489,217,203,-14,64,972,987
9490,725,339,-386,41,600,615
9491,748,960,212,15,198,213
9492,33,560,527,37,513,528
9493,832,916,84,7,70,85
9494,786,893,107,10,93,108
9495,294,24,-270,48,716,731
9496,677,682,5,3,3,6
9497,86,956,870,57,856,871
9498,439,458,19,4,5,20
9499,747,733,-14,64,972,987
9500,993,936,-57,63,929,944
9501,560,773,213,16,199,214
9502,167,495,328,22,314,329
9503,313,109,-204,52,782,797
9504,337,986,649,43,635,650
9505,34,564,530,35,516,531
9506,514,424,-90,60,896,911
9507,409,453,44,5,30,45
9508,58,774,716,47,702,717
9509,342,166,-176,53,810,825
9510,423,257,-166,54,820,835
9511,474,524,50,5,36,51
9512,163,359,196,14,182,197
9513,178,645,467,32,453,468
9514,680,604,-76,60,910,925
9515,199,895,696,45,682,697
9516,604,441,-163,55,823,838
9517,914,225,-689,23,297,312
9518,872,726,-146,56,840,855
9519,674,681,7,4,5,8
9520,105,956,851,56,837,852
9521,627,793,166,13,152,167
9522,968,260,-708,20,278,293
9523,200,434,234,17,220,235
9524,997,736,-261,49,725,740
9525,628,881,253,19,239,254
9526,270,535,265,19,251,266
9527,352,202,-150,55,836,851
9528,21,32,11,4,5,12
9529,102,173,71,8,57,72
9530,564,74,-490,35,496,511
9531,948,33,-915,8,71,86
9532,763,730,-33,64,953,968
9533,726,295,-431,38,555,570
9534,867,728,-139,57,847,862
9535,947,856,-91,60,895,910
9536,487,53,-434,38,552,567
9537,40,475,435,30,421,436
9538,828,719,-109,59,877,892
9539,765,320,-445,38,541,556
9540,892,68,-824,12,162,177
9541,721,431,-290,47,696,711
9542,400,87,-313,47,673,688
9543,206,376,170,13,156,171
9544,457,880,423,30,409,424
9545,23,619,596,39,582,597
9546,770,623,-147,56,839,854
9547,384,472,88,7,74,89
9548,76,100,24,3,10,25
9549,799,807,8,2,2,9
9550,543,118,-425,40,561,576
9551,572,474,-98,59,888,903
9552,956,787,-169,56,817,832
9553,315,713,398,28,384,399
9554,72,124,52,5,38,53
9555,505,420,-85,60,901,916
9556,168,128,-40,61,946,961
9557,892,324,-568,28,418,433
9558,771,638,-133,57,853,868
9559,604,683,79,9,65,80
9560,569,68,-501,34,485,500
9561,587,110,-477,36,509,524
9562,346,634,288,19,274,289
9563,250,99,-151,55,835,850
9564,933,3,-930,7,56,71
9565,869,26,-843,13,143,158
9566,884,684,-200,51,786,801
9567,409,630,221,17,207,222
9568,128,208,80,6,66,81
9569,359,49,-310,45,676,691
9570,401,165,-236,50,750,765
9571,116,931,815,55,801,816
9572,69,274,205,16,191,206
9573,179,531,352,23,338,353
9574,260,357,97,8,83,98
9575,35,977,942,62,928,943
9576,461,493,32,3,18,33
9577,866,794,-72,59,914,929
9578,319,236,-83,60,903,918
9579,787,517,-270,48,716,731
9580,988,873,-115,58,871,886
9581,780,781,1,2,2,2
9582,127,919,792,51,778,793
9583,255,271,16,2,2,17
9584,311,594,283,21,269,284
9585,164,695,531,36,517,532
9586,774,64,-710,20,276,291
9587,376,134,-242,50,744,759
9588,500,754,254,19,240,255
9589,809,967,158,13,144,159
9590,164,254,90,8,76,91
9591,298,408,110,10,96,111
9592,489,709,220,16,206,221
9593,253,522,269,20,255,270
9594,949,414,-535,31,451,466
9595,174,606,432,28,418,433
9596,196,440,244,17,230,245
9597,117,406,289,20,275,290
9598,258,309,51,6,37,52
9599,615,312,-303,46,683,698
9600,459,795,336,22,322,337
9601,689,725,36,4,22,37
9602,621,91,-530,32,456,471
9603,899,866,-33,64,953,968
9604,730,609,-121,59,865,880
9605,258,974,716,47,702,717
9606,184,624,440,29,426,441
9607,618,242,-376,40,610,625
9608,765,233,-532,31,454,469
9609,754,517,-237,51,749,764
9610,771,914,143,13,129,144
9611,514,358,-156,55,830,845
9612,730,554,-176,53,810,825
9613,87,113,26,4,12,27
9614,707,250,-457,38,529,544
9615,24,222,198,15,184,199
9616,667,619,-48,61,938,953
9617,175,211,36,4,22,37
9618,582,871,289,20,275,290
9619,696,975,279,21,265,280
9620,323,617,294,21,280,295
9621,624,856,232,16,218,233
9622,687,94,-593,29,393,408
9623,686,511,-175,54,811,826
9624,289,166,-123,58,863,878
9625,490,844,354,24,340,355
9626,497,288,-209,53,777,792
9627,287,652,365,26,351,366
9628,703,800,97,8,83,98
9629,430,580,150,12,136,151
9630,272,204,-68,60,918,933
9631,522,803,281,20,267,282
9632,690,161,-529,33,457,472
9633,744,480,-264,47,722,737
9634,926,872,-54,61,932,947
9635,768,908,140,11,126,141
9636,88,128,40,4,26,41
9637,356,100,-256,48,730,745
9638,50,137,87,9,73,88
9639,7,72,65,6,51,66
9640,279,5,-274,48,712,727
9641,272,977,705,46,691,706
9642,410,367,-43,63,943,958
9643,242,687,445,31,431,446
9644,658,523,-135,56,851,866
9645,584,922,338,23,324,339
9646,946,41,-905,10,81,96
9647,966,81,-885,10,101,116
9648,899,696,-203,53,783,798
9649,271,316,45,6,31,46
9650,931,738,-193,54,793,808
9651,69,466,397,28,383,398
9652,407,778,371,26,357,372
9653,667,688,21,4,7,22
9654,74,457,383,28,369,384
9655,449,515,66,6,52,67
9656,743,494,-249,51,737,752
9657,162,274,112,8,98,113
9658,447,906,459,32,445,460
9659,380,193,-187,54,799,814
9660,838,749,-89,61,897,912
9661,5,548,543,38,529,544
9662,610,920,310,22,296,311
9663,192,11,-181,54,805,820
9664,729,96,-633,27,353,368
9665,281,90,-191,53,795,810
9666,629,826,197,15,183,198
9667,861,850,-11,65,975,990
9668,845,994,149,12,135,150
9669,34,245,211,16,197,212
9670,649,650,1,2,2,2
9671,39,333,294,21,280,295
9672,527,749,222,17,208,223
9673,478,747,269,20,255,270
9674,94,607,513,34,499,514
9675,156,418,262,19,248,263
9676,98,826,728,47,714,729
9677,185,513,328,22,314,329
9678,547,429,-118,57,868,883
9679,677,637,-40,61,946,961
9680,30,10,-20,63,966,981
9681,942,588,-354,43,632,647
9682,521,272,-249,51,737,752
9683,616,979,363,26,349,364
9684,848,251,-597,28,389,404
9685,663,418,-245,50,741,756
9686,734,927,193,14,179,194
9687,499,315,-184,52,802,817
9688,769,192,-577,30,409,424
9689,707,499,-208,51,778,793
9690,736,843,107,10,93,108
9691,493,27,-466,36,520,535
9692,453,345,-108,58,878,893
9693,566,887,321,22,307,322
9694,873,875,2,2,2,3
9695,148,890,742,49,728,743
9696,778,923,145,11,131,146
9697,823,261,-562,30,424,439
9698,499,964,465,31,451,466
9699,943,853,-90,60,896,911
9700,587,93,-494,34,492,507
9701,865,514,-351,43,635,650
9702,518,124,-394,41,592,607
9703,796,891,95,10,81,96
9704,105,306,201,15,187,202
9705,724,618,-106,59,880,895
9706,933,8,-925,8,61,76
9707,237,859,622,42,608,623
9708,862,4,-858,12,128,143
9709,22,478,456,30,442,457
9710,416,142,-274,48,712,727
9711,109,527,418,28,404,419
9712,163,654,491,34,477,492
9713,120,594,474,32,460,475
9714,576,287,-289,48,697,712
9715,721,302,-419,39,567,582
9716,84,434,350,25,336,351
9717,372,968,596,39,582,597
9718,914,687,-227,51,759,774
9719,733,837,104,8,90,105
9720,351,891,540,36,526,541
9721,151,666,515,35,501,516
9722,211,449,238,18,224,239
9723,312,563,251,19,237,252
9724,739,714,-25,65,961,976
9725,41,805,764,50,750,765
9726,743,870,127,12,113,128
9727,94,363,269,20,255,270
9728,465,996,531,36,517,532
9729,875,153,-722,20,264,279
9730,347,472,125,11,111,126
9731,711,717,6,3,4,7
9732,228,248,20,3,6,21
9733,168,468,300,21,286,301
9734,986,735,-251,50,735,750
9735,809,284,-525,33,461,476
9736,859,917,58,6,44,59
9737,394,922,528,34,514,529
9738,170,112,-58,62,928,943
9739,992,410,-582,28,404,419
9740,357,293,-64,60,922,937
9741,636,241,-395,41,591,606
9742,960,543,-417,40,569,584
9743,34,847,813,54,799,814
9744,226,164,-62,61,924,939
9745,161,148,-13,65,973,988
9746,801,80,-721,21,265,280
9747,467,192,-275,48,711,726
9748,594,142,-452,36,534,549
9749,315,232,-83,60,903,918
9750,316,260,-56,60,930,945
9751,967,634,-333,45,653,668
9752,627,965,338,23,324,339
9753,687,737,50,5,36,51
9754,574,750,176,12,162,177
9755,887,784,-103,58,883,898
9756,773,498,-275,48,711,726
9757,277,582,305,21,291,306
9758,195,421,226,16,212,227
9759,362,552,190,15,176,191
9760,706,406,-300,46,686,701
9761,538,104,-434,38,552,567
9762,533,145,-388,40,598,613
9763,122,256,134,11,120,135
9764,239,9,-230,50,756,771
9765,694,511,-183,53,803,818
9766,460,909,449,30,435,450
9767,707,577,-130,57,856,871
9768,659,474,-185,55,801,816
9769,457,896,439,31,425,440
9770,764,941,177,13,163,178
9771,233,783,550,37,536,551
9772,687,748,61,7,47,62
9773,691,538,-153,57,833,848
9774,197,352,155,13,141,156
9775,377,79,-298,47,688,703
9776,114,290,176,12,162,177
9777,94,201,107,10,93,108
9778,327,698,371,26,357,372
9779,582,373,-209,53,777,792
9780,275,141,-134,56,852,867
9781,661,540,-121,59,865,880
9782,773,431,-342,43,644,659
9783,956,189,-767,17,219,234
9784,702,62,-640,24,346,361
9785,720,323,-397,41,589,604
9786,627,156,-471,35,515,530
9787,338,306,-32,62,954,969
9788,657,262,-395,41,591,606
9789,166,229,63,8,49,64
9790,769,215,-554,31,432,447
9791,861,812,-49,63,937,952
9792,845,299,-546,31,440,455
9793,218,874,656,42,642,657
9794,698,283,-415,39,571,586
9795,501,49,-452,36,534,549
9796,415,584,169,13,155,170
9797,430,959,529,35,515,530
9798,465,525,60,6,46,61
9799,557,874,317,23,303,318
9800,569,182,-387,41,599,614
9801,916,161,-755,18,231,246
9802,305,101,-204,52,782,797
9803,583,224,-359,42,627,642
9804,769,663,-106,59,880,895
9805,848,24,-824,12,162,177
9806,980,408,-572,29,414,429
9807,215,199,-16,63,970,985
9808,194,460,266,19,252,267
9809,526,719,193,14,179,194
9810,81,349,268,19,254,269
9811,989,575,-414,39,572,587
9812,510,381,-129,58,857,872
9813,899,803,-96,58,890,905
9814,801,903,102,9,88,103
9815,125,201,76,7,62,77
9816,25,400,375,27,361,376
9817,430,417,-13,65,973,988
9818,206,754,548,36,534,549
9819,61,707,646,43,632,647
9820,810,262,-548,30,438,453
9821,421,399,-22,63,964,979
9822,925,804,-121,59,865,880
9823,964,318,-646,24,340,355
9824,586,93,-493,35,493,508
9825,127,99,-28,63,958,973
9826,614,153,-461,37,525,540
9827,574,336,-238,50,748,763
9828,501,311,-190,53,796,811
9829,356,190,-166,54,820,835
9830,889,33,-856,10,130,145
9831,722,124,-598,27,388,403
9832,557,835,278,20,264,279
9833,379,792,413,29,399,414
9834,279,184,-95,59,891,906
9835,729,784,55,7,41,56
9836,205,784,579,39,565,580
9837,480,688,208,14,194,209
9838,624,874,250,18,236,251
9839,29,643,614,41,600,615
9840,892,882,-10,65,976,991
9841,303,43,-260,48,726,741
9842,239,116,-123,58,863,878
9843,809,263,-546,31,440,455
9844,62,365,303,23,289,304
9845,534,130,-404,39,582,597
9846,136,540,404,27,390,405
9847,279,148,-131,57,855,870
9848,942,447,-495,34,491,506
9849,94,95,1,2,2,2
9850,690,531,-159,55,827,842
9851,127,49,-78,60,908,923
9852,172,860,688,44,674,689
9853,445,828,383,28,369,384
9854,850,2,-848,11,138,153
9855,281,13,-268,48,718,733
9856,118,219,101,9,87,102
9857,417,961,544,35,530,545
9858,722,638,-84,59,902,917
9859,812,388,-424,37,562,577
9860,116,228,112,8,98,113
9861,962,515,-447,37,539,554
9862,675,580,-95,59,891,906
9863,962,37,-925,8,61,76
9864,749,704,-45,63,941,956
9865,905,173,-732,19,254,269
9866,353,424,71,8,57,72
9867,103,146,43,6,29,44
9868,779,607,-172,54,814,829
9869,705,366,-339,44,647,662
9870,767,168,-599,27,387,402
9871,35,478,443,31,429,444
9872,965,242,-723,20,263,278
9873,858,314,-544,30,442,457
9874,934,340,-594,28,392,407
9875,687,327,-360,41,626,641
9876,766,991,225,16,211,226
9877,379,794,415,30,401,416
9878,864,558,-306,46,680,695
9879,563,407,-156,55,830,845
9880,14,42,28,4,14,29
9881,589,29,-560,29,426,441
9882,62,991,929,60,915,930
9883,212,754,542,37,528,543
9884,199,305,106,9,92,107
9885,948,404,-544,30,442,457
9886,337,951,614,41,600,615
9887,195,73,-122,58,864,879
9888,909,622,-287,47,699,714
9889,58,255,197,15,183,198
9890,141,376,235,18,221,236
9891,411,621,210,15,196,211
9892,117,754,637,43,623,638
9893,506,724,218,16,204,219
9894,148,754,606,41,592,607
9895,797,419,-378,42,608,623
9896,320,885,565,38,551,566
9897,849,222,-627,26,359,374
9898,734,663,-71,60,915,930
9899,888,507,-381,42,605,620
9900,141,437,296,20,282,297
9901,373,802,429,30,415,430
9902,326,850,524,35,510,525
9903,279,787,508,34,494,509
9904,287,98,-189,54,797,812
9905,375,881,506,34,492,507
9906,273,783,510,35,496,511
9907,844,532,-312,44,674,689
9908,78,982,904,58,890,905
9909,4,147,143,13,129,144
9910,161,888,727,49,713,728
9911,870,979,109,10,95,110
9912,918,367,-551,30,435,450
9913,660,832,172,13,158,173
9914,682,238,-444,37,542,557
9915,177,15,-162,55,824,839
9916,791,518,-273,49,713,728
9917,440,322,-118,57,868,883
9918,763,252,-511,33,475,490
9919,194,544,350,25,336,351
9920,225,483,258,18,244,259
9921,594,154,-440,36,546,561
9922,975,247,-728,18,258,273
9923,394,98,-296,45,690,705
9924,677,775,98,8,84,99
9925,145,141,-4,64,982,997
9926,108,972,864,55,850,865
9927,177,612,435,30,421,436
9928,296,284,-12,64,974,989
9929,33,981,948,61,934,949
9930,239,714,475,33,461,476
9931,49,108,59,7,45,60
9932,851,91,-760,16,226,241
9933,137,646,509,35,495,510
9934,349,591,242,17,228,243
9935,741,132,-609,28,377,392
9936,552,875,323,23,309,324
9937,177,522,345,24,331,346
9938,803,51,-752,17,234,249
9939,946,494,-452,36,534,549
9940,281,457,176,12,162,177
9941,646,211,-435,38,551,566
9942,847,423,-424,37,562,577
9943,428,65,-363,43,623,638
9944,672,971,299,22,285,300
9945,912,703,-209,53,777,792
9946,17,851,834,54,820,835
9947,559,133,-426,39,560,575
9948,444,183,-261,49,725,740
9949,574,938,364,25,350,365
9950,887,460,-427,39,559,574
9951,391,509,118,10,104,119
9952,839,452,-387,41,599,614
9953,158,229,71,8,57,72
9954,858,29,-829,14,157,172
9955,970,599,-371,42,615,630
9956,615,157,-458,37,528,543
9957,435,431,-4,64,982,997
9958,54,437,383,28,369,384
9959,92,199,107,10,93,108
9960,893,474,-419,39,567,582
9961,783,771,-12,64,974,989
9962,95,325,230,17,216,231
9963,436,632,196,14,182,197
9964,330,55,-275,48,711,726
9965,620,402,-218,52,768,783
9966,846,998,152,11,138,153
9967,822,121,-701,22,285,300
9968,18,459,441,30,427,442
9969,327,935,608,39,594,609
9970,406,4,-402,40,584,599
9971,705,115,-590,28,396,411
9972,234,322,88,7,74,89
9973,345,364,19,4,5,20
9974,788,157,-631,25,355,370
9975,492,484,-8,63,978,993
9976,671,496,-175,54,811,826
9977,882,727,-155,56,831,846
9978,785,20,-765,18,221,236
9979,463,497,34,4,20,35
9980,76,932,856,55,842,857
9981,901,494,-407,39,579,594
9982,802,696,-106,59,880,895
9983,946,932,-14,64,972,987
9984,970,240,-730,20,256,271
9985,925,763,-162,55,824,839
9986,975,159,-816,13,170,185
9987,105,261,156,12,142,157
9988,382,491,109,10,95,110
9989,339,602,263,20,249,264
9990,420,61,-359,42,627,642
9991,684,609,-75,61,911,926
9992,763,300,-463,36,523,538
9993,880,910,30,5,16,31
9994,541,716,175,15,161,176
9995,677,352,-325,45,661,676
9996,910,273,-637,26,349,364
9997,111,677,566,38,552,567
9998,507,384,-123,58,863,878
9999,237,713,476,32,462,477
